bill_id,roll_call_id,date,chamber,description,yea,nay,nv,absent,total
1385398,1051885,2021-04-13,Senate,"Do pass, but first be re-referred to the Committee on [Appropriations]",6,2,1,0,9
1385398,1056349,2021-04-19,Senate,"Placed on suspense file",7,0,0,0,7
1385399,1053495,2021-04-14,Assembly,"Do pass as amended and be re-referred to the Committee on [Local Government]",11,0,0,0,11
1385399,1065087,2021-04-28,Assembly,"Do pass and be re-referred to the Committee on [Appropriations] with recommendation: To Consent Calendar",8,0,0,0,8
1385400,1060937,2021-04-22,Assembly,"Do pass and be re-referred to the Committee on [Appropriations]",6,0,1,0,7
1385401,988135,2021-01-15,Assembly,"AB 84 Ting Assembly Third Reading",48,13,19,0,80
1385401,1028411,2021-03-15,Senate,"Do pass",13,5,0,0,18
1385401,1050801,2021-04-12,Senate,"Do pass",13,3,2,0,18
1385402,1059244,2021-04-21,Assembly,"Be adopted. To third reading",9,0,0,0,9
1385402,1066773,2021-04-29,Assembly,"AJR 2 O'Donnell Assembly Third Reading",75,0,3,0,78
1385403,1029577,2021-03-16,Senate,"Do pass, but first be re-referred to the Committee on [Governance and Finance]",7,2,0,0,9
1385403,1054638,2021-04-15,Senate,"Do pass, but first be re-referred to the Committee on [Appropriations]",5,0,0,0,5
1385403,1068261,2021-05-03,Senate,"Placed on suspense file",6,0,1,0,7
1385404,1048964,2021-04-08,Assembly,"Do pass as amended and be re-referred to the Committee on [Appropriations]",7,0,0,0,7
1385405,1053488,2021-04-14,Assembly,"Do pass and be re-referred to the Committee on [Human Services]",6,0,1,0,7
1385405,1059302,2021-04-21,Assembly,"Do pass as amended and be re-referred to the Committee on [Appropriations]",8,0,0,0,8
1385407,1053515,2021-04-14,Assembly,"Do pass and be re-referred to the Committee on [Appropriations] with recommendation: To Consent Calendar",11,0,0,0,11
1385415,984521,2021-01-11,Assembly,"Be adopted. To third reading",11,0,1,0,12
1385416,1026091,2021-03-10,Senate,"Do pass, but first be re-referred to the Committee on [Public Safety]",7,3,1,0,11
1385416,1046117,2021-04-06,Senate,"Do pass",4,1,0,0,5
1385416,1060900,2021-04-22,Senate,"Senate 3rd Reading SB57 Wiener et al",21,11,8,0,40
1385418,1066748,2021-04-29,Senate,"Senate 3rd Reading SCR4 Umberg et al",37,0,3,0,40
1385418,1077537,2021-05-13,Assembly,"Be adopted. To Consent Calendar",10,0,2,0,12
1385421,1048873,2021-04-08,Assembly,"Do pass and be re-referred to the Committee on [Appropriations]",22,0,0,0,22
1385422,1064041,2021-04-27,Senate,"Do pass as amended, but first amend, and re-refer to the Committee on [Appropriations] with the recommendation: To Consent Calendar",15,0,2,0,17
1385422,1075306,2021-05-10,Senate,"Placed on suspense file",7,0,0,0,7
1385423,1054610,2021-04-15,Assembly,"Do pass and be re-referred to the Committee on [Appropriations]",5,0,2,0,7
1385423,1065253,2021-04-28,Assembly,"Do pass",12,0,4,0,16
1385424,1050806,2021-04-12,Senate,"Do pass as amended, but first amend, and re-refer to the Committee on [Judiciary]",11,1,2,0,14
1385424,1068231,2021-05-03,Senate,"Placed on suspense file",6,0,1,0,7
1385425,1062763,2021-04-26,Senate,"Do pass, but first be re-referred to the Committee on [Appropriations] with the recommendation: To Consent Calendar",7,0,0,0,7
1385425,1075269,2021-05-10,Senate,"Placed on suspense file",7,0,0,0,7
1385427,988119,2021-01-15,Assembly,"AB 87 Ting Assembly Third Reading",48,13,19,0,80
1385427,1065075,2021-04-28,Senate,"Do pass",12,5,1,0,18
1385428,1056359,2021-04-19,Senate,"Do pass as amended, but first amend, and re-refer to the Committee on [Judiciary]",10,2,2,0,14
1385430,1062748,2021-04-26,Senate,"Do pass, but first be re-referred to the Committee on [Appropriations]",5,1,1,0,7
1385431,1049027,2021-04-07,Assembly,"Do pass as amended and be re-referred to the Committee on [Appropriations]",7,0,0,0,7
1385432,1056340,2021-04-19,Senate,"Do pass as amended, but first amend, and re-refer to the Committee on [Appropriations]",9,3,2,0,14
1385432,1075265,2021-05-10,Senate,"Placed on suspense file",7,0,0,0,7
1385433,1028418,2021-03-15,Senate,"Do pass as amended, but first amend, and re-refer to the Committee on [Appropriations]",5,2,0,0,7
1385433,1045009,2021-04-05,Senate,"Placed on suspense file",7,0,0,0,7
1385434,1037856,2021-03-25,Senate,"Do pass, but first be re-referred to the Committee on [Housing]",5,0,0,0,5
1385434,1066790,2021-04-29,Senate,"Do pass as amended, but first amend, and re-refer to the Committee on [Appropriations]",8,1,0,0,9
1385435,1054648,2021-04-15,Assembly,"Do pass as amended and be re-referred to the Committee on [Appropriations]",7,0,1,0,8
1385436,1048971,2021-04-08,Senate,"Do pass as amended, and be ordered to the Consent Calendar",12,0,0,0,12
1385436,1060998,2021-04-22,Senate,"Consent Calendar SB11",38,0,2,0,40
1385437,1033609,2021-03-22,Senate,"Do pass, but first be re-referred to the Committee on [Governance and Finance]",14,0,0,0,14
1385437,1074148,2021-05-06,Senate,"Do pass as amended, but first amend, and re-refer to the Committee on [Appropriations]",5,0,0,0,5
1385439,1023826,2021-03-08,Senate,"Do pass, but first be re-referred to the Committee on [Judiciary]",5,0,0,0,5
1385439,1035270,2021-03-23,Senate,"Do pass, but first be re-referred to the Committee on [Appropriations] with the recommendation: To Consent Calendar",11,0,0,0,11
1385439,1075354,2021-05-10,Senate,"Consent Calendar SB58 Wilk et al. Urgency Clause",37,0,3,0,40
1385442,1036520,2021-03-23,Assembly,"Do pass as amended and be re-referred to the Committee on [Appropriations]",6,2,0,0,8
1385443,988134,2021-01-15,Assembly,"AB 82 Ting Assembly Third Reading",48,13,19,0,80
1385443,1009522,2021-02-18,Senate,"Do pass",17,0,1,0,18
1385443,1011742,2021-02-22,Senate,"Assembly 3rd Reading AB82 Ting By Skinner",38,0,1,0,39
1385443,1011743,2021-02-22,Assembly,"AB 82 TING Assembly Third Reading",77,0,2,0,79
1385443,1013297,2021-02-22,Assembly,"AB 82 TING Concurrence in Senate Amendments",77,0,2,0,79
1385446,988125,2021-01-15,Assembly,"AB 86 Ting Assembly Third Reading",48,13,19,0,80
1385446,1020027,2021-03-02,Senate,"Do pass",18,0,0,0,18
1385446,1022323,2021-03-04,Senate,"Assembly 3rd Reading AB86 BUDGET (Ting) By Skinner",36,0,3,0,39
1385446,1022324,2021-03-04,Assembly,"AB 86 BUDGET Concurrence in Senate Amendments By TING",72,4,3,0,79
1385447,1028434,2021-03-15,Senate,"Do pass, but first be re-referred to the Committee on [Natural Resources and Water]",5,0,2,0,7
1385447,1064146,2021-04-27,Senate,"Do pass, but first be re-referred to the Committee on [Appropriations]",7,0,2,0,9
1385447,1075274,2021-05-10,Senate,"Placed on suspense file",7,0,0,0,7
1385448,1046148,2021-04-05,Senate,"Do pass as amended, but first amend, and re-refer to the Committee on [Appropriations]",5,0,0,0,5
1385448,1068195,2021-05-03,Senate,"Senate 3rd Reading SB33 Cortese",36,0,4,0,40
1385449,988131,2021-01-15,Assembly,"AB 79 Ting Assembly Third Reading",48,13,19,0,80
1385449,990809,2021-01-26,Senate,"Do pass",16,0,2,0,18
1385449,1050769,2021-04-12,Senate,"Do pass",16,0,2,0,18
1385453,983019,2020-12-07,Senate,"W/O REF. TO FILE SCR1 Umberg",36,0,0,0,36
1385453,983020,2020-12-07,Assembly,"SCR 1 Umberg Senate Third Reading By REYES",75,0,5,0,80
1385455,1046214,2021-04-06,Assembly,"Do pass as amended and be re-referred to the Committee on [Appropriations]",15,0,0,0,15
1385456,1065157,2021-04-28,Senate,"Do pass as amended, but first amend, and re-refer to the Committee on [Appropriations]",7,0,0,0,7
1385459,1026145,2021-03-10,Senate,"Do pass, but first be re-referred to the Committee on [Governance and Finance]",5,1,1,0,7
1385459,1048945,2021-04-08,Senate,"Do pass, but first be re-referred to the Committee on [Appropriations]",5,0,0,0,5
1385459,1056336,2021-04-19,Senate,"Placed on suspense file",7,0,0,0,7
1385460,1053461,2021-04-13,Assembly,"Do pass and be re-referred to the Committee on [Governmental Organization]",6,7,6,0,19
1385461,988128,2021-01-15,Assembly,"AB 88 Ting Assembly Third Reading",48,13,19,0,80
1385461,1009543,2021-02-18,Senate,"Do pass",13,0,5,0,18
1385461,1028397,2021-03-15,Senate,"Do pass",14,0,4,0,18
1385461,1028398,2021-03-15,Senate,"Assembly 3rd Reading AB88 BUDGET (Ting) By Skinner",32,0,8,0,40
1385461,1028399,2021-03-15,Assembly,"AB 88 BUDGET Concurrence in Senate Amendments By TING",66,0,12,0,78
1385462,1036528,2021-03-23,Assembly,"Do pass and be re-referred to the Committee on [Appropriations]",6,2,0,0,8
1385463,1028408,2021-03-15,Senate,"Do pass as amended, but first amend, and re-refer to the Committee on [Environmental Quality]",12,0,2,0,14
1385463,1066675,2021-04-29,Senate,"Do pass as amended, but first amend, and re-refer to the Committee on [Appropriations]",6,0,1,0,7
1385464,1036538,2021-03-24,Senate,"Do pass as amended, but first amend, and re-refer to the Committee on [Governance and Finance]",4,2,1,0,7
1385464,1068162,2021-05-03,Senate,"Placed on suspense file",6,0,1,0,7
1385465,1063990,2021-04-27,Assembly,"Do pass and be re-referred to the Committee on [Appropriations]",13,0,2,0,15
1385466,983022,2020-12-07,Assembly,"HR 2 RENDON Assembly Third Reading By REYES",75,0,5,0,80
1385467,1064152,2021-04-27,Assembly,"Do pass as amended and be re-referred to the Committee on [Appropriations]",14,1,0,0,15
1385468,1054735,2021-04-15,Senate,"Do pass, but first be re-referred to the Committee on [Governance and Finance]",7,2,0,0,9
1385468,1060850,2021-04-22,Senate,"Do pass as amended, but first amend, and re-refer to the Committee on [Appropriations]",5,0,0,0,5
1385468,1075292,2021-05-10,Senate,"Placed on suspense file",7,0,0,0,7
1385470,1054592,2021-04-15,Assembly,"Do pass and be re-referred to the Committee on [Appropriations] with recommendation: To Consent Calendar",13,0,0,0,13
1385471,1047468,2021-04-06,Assembly,"Do pass and be re-referred to the Committee on [Appropriations]",2,5,1,0,8
1385472,1029568,2021-03-16,Senate,"Do pass, but first be re-referred to the Committee on [Housing]",8,0,1,0,9
1385472,1066696,2021-04-29,Senate,"Do pass as amended, but first amend, and re-refer to the Committee on [Appropriations]",8,0,1,0,9
1385473,1027196,2021-03-11,Senate,"Do pass",5,0,0,0,5
1385473,1031899,2021-03-18,Senate,"Senate 3rd Reading SB60 Glazer et al",32,5,3,0,40
1385475,1053562,2021-04-14,Senate,"Do pass, but first be re-referred to the Committee on [Human Services]",11,0,0,0,11
1385476,1064126,2021-04-26,Assembly,"Do pass and be re-referred to the Committee on [Appropriations]",11,4,0,0,15
1385477,1054620,2021-04-15,Assembly,"Do pass and be re-referred to the Committee on [Appropriations]",6,1,0,0,7
1385478,1026103,2021-03-10,Senate,"Do pass, but first be re-referred to the Committee on [Appropriations]",9,2,0,0,11
1385478,1033622,2021-03-22,Senate,"Placed on suspense file",7,0,0,0,7
1385480,1065106,2021-04-27,Assembly,"Do pass as amended and be re-referred to the Committee on [Appropriations]",7,1,0,0,8
1385481,1027160,2021-03-11,Senate,"Do pass, but first be re-referred to the Committee on [Housing]",5,0,0,0,5
1385481,1066787,2021-04-29,Senate,"Do pass, but first be re-referred to the Committee on [Appropriations]",8,0,1,0,9
1385481,1075321,2021-05-10,Senate,"Placed on suspense file",7,0,0,0,7
1385482,1051995,2021-04-13,Senate,"Do pass, but first be re-referred to the Committee on [Judiciary]",4,0,1,0,5
1385482,1065265,2021-04-27,Senate,"Do pass as amended, but first amend, and re-refer to the Committee on [Appropriations]",7,2,2,0,11
1385482,1075353,2021-05-10,Senate,"Placed on suspense file",7,0,0,0,7
1385484,1059317,2021-04-20,Assembly,"Do pass and be re-referred to the Committee on [Public Employment and Retirement]",6,0,2,0,8
1385484,1066826,2021-04-29,Assembly,"Do pass as amended and be re-referred to the Committee on [Appropriations]",6,0,1,0,7
1385486,983023,2020-12-07,Assembly,"HR 3 RENDON Assembly Third Reading By REYES",75,0,5,0,80
1385487,1029566,2021-03-16,Senate,"Do pass as amended, but first amend, and re-refer to the Committee on [Labor, Public Employment and Retirement ]",4,0,1,0,5
1385487,1064089,2021-04-26,Senate,"Do pass, but first be re-referred to the Committee on [Appropriations]",5,0,0,0,5
1385487,1075304,2021-05-10,Senate,"Placed on suspense file",7,0,0,0,7
1385488,1038741,2021-03-22,Senate,"Do pass, but first be re-referred to the Committee on [Judiciary]",4,0,1,0,5
1385488,1047600,2021-04-06,Senate,"Do pass as amended, but first amend, and re-refer to the Committee on [Appropriations]",9,2,0,0,11
1385488,1056407,2021-04-19,Senate,"Placed on suspense file",7,0,0,0,7
1385492,1056317,2021-04-19,Assembly,"Do pass and be re-referred to the Committee on [Appropriations]",15,0,0,0,15
1385492,1073334,2021-05-05,Assembly,"Do pass",14,1,1,0,16
1385492,1075380,2021-05-10,Assembly,"AB 43 Friedman Assembly Third Reading",65,3,10,0,78
1385493,1031873,2021-03-18,Senate,"Do pass, but first be re-referred to the Committee on [Appropriations]",7,1,1,0,9
1385493,1044978,2021-04-05,Senate,"Placed on suspense file",7,0,0,0,7
1385495,1057699,2021-04-19,Assembly,"Do pass and be re-referred to the Committee on [Housing and Community Development]",7,4,0,0,11
1385495,1067617,2021-04-29,Assembly,"Do pass as amended and be re-referred to the Committee on [Appropriations]",5,2,1,0,8
1385498,1054637,2021-04-15,Assembly,"Do pass and be re-referred to the Committee on [Governmental Organization]",5,1,1,0,7
1385498,1060868,2021-04-22,Assembly,"Do pass and be re-referred to the Committee on [Appropriations]",14,4,4,0,22
1385499,993690,2021-02-01,Senate,"Do pass, but first be re-referred to the Committee on [Appropriations]",15,0,2,0,17
1385499,996626,2021-02-04,Senate,"Do pass",4,0,2,0,6
1385499,1005313,2021-02-12,Senate,"Senate 3rd Reading SB51 Durazo et al. Urgency Clause",32,0,7,0,39
1385499,1029555,2021-03-15,Assembly,"Do pass and be re-referred to the Committee on [Appropriations]",8,0,0,0,8
1385499,1031886,2021-03-18,Assembly,"Do pass",16,0,0,0,16
1385500,1036434,2021-03-23,Assembly,"Do pass as amended, and be re-referred to the Committee on [Appropriations] with recommendation: To Consent Calendar",8,0,0,0,8
1385501,1025096,2021-03-09,Senate,"Do pass, but first be re-referred to the Committee on [Appropriations]",14,0,0,0,14
1385501,1033657,2021-03-22,Senate,"Placed on suspense file",7,0,0,0,7
1385502,1050779,2021-04-12,Senate,"Do pass, but first be re-referred to the Committee on [Governmental Organization]",14,0,0,0,14
1385502,1057695,2021-04-20,Senate,"Do pass as amended, but first amend, and re-refer to the Committee on [Appropriations]",11,0,4,0,15
1385503,983025,2020-12-07,Assembly,"HR 1 COOLEY Assembly Third Reading",56,19,5,0,80
1385505,1062745,2021-04-26,Senate,"Do pass, but first be re-referred to the Committee on [Appropriations]",7,0,0,0,7
1385505,1075281,2021-05-10,Senate,"Placed on suspense file",7,0,0,0,7
1385506,1048963,2021-04-08,Assembly,"Do pass and be re-referred to the Committee on [Appropriations]",5,2,0,0,7
1385507,1053548,2021-04-14,Assembly,"Do pass and be re-referred to the Committee on [Appropriations]",11,0,0,0,11
1385508,1059221,2021-04-21,Assembly,"Do pass and be re-referred to the Committee on [Appropriations]",8,0,0,0,8
1385509,1048962,2021-04-08,Assembly,"Do pass and be re-referred to the Committee on [Appropriations]",9,0,2,0,11
1385516,1028407,2021-03-15,Senate,"Do pass as amended, but first amend, and re-refer to the Committee on [Rules]",4,0,1,0,5
1385516,1051895,2021-04-13,Senate,"Do pass, but first be re-referred to the Committee on [Appropriations]",4,0,1,0,5
1385516,1075338,2021-05-10,Senate,"Senate 3rd Reading SB35 Umberg",29,2,9,0,40
1385517,1036522,2021-03-23,Assembly,"Do pass and be re-referred to the Committee on [Appropriations]",8,0,0,0,8
1385518,1048892,2021-04-08,Assembly,"Do pass and be re-referred to the Committee on [Insurance] with recommendation: To Consent Calendar",11,0,0,0,11
1385518,1066336,2021-04-29,Assembly,"Do pass and be re-referred to the Committee on [Appropriations] with recommendation: To Consent Calendar",13,0,0,0,13
1385518,1076922,2021-05-12,Assembly,"Do pass. To Consent Calendar",16,0,0,0,16
1385521,1065145,2021-04-27,Assembly,"Do pass",6,2,0,0,8
1385522,1048950,2021-04-07,Assembly,"Do pass and be re-referred to the Committee on [Higher Education]",5,0,2,0,7
1385522,1060911,2021-04-22,Assembly,"Do pass and be re-referred to the Committee on [Appropriations]",10,0,2,0,12
1385523,988118,2021-01-15,Assembly,"AB 81 Ting Assembly Third Reading",48,13,19,0,80
1385523,1009564,2021-02-18,Senate,"Do pass",16,0,2,0,18
1385523,1011709,2021-02-22,Senate,"Assembly 3rd Reading AB81 Ting By Skinner",37,0,2,0,39
1385523,1011710,2021-02-22,Assembly,"AB 81 TING Concurrence in Senate Amendments",77,0,2,0,79
1385524,1031897,2021-03-18,Senate,"Do pass as amended, but first amend, and re-refer to the Committee on [Governance and Finance]",7,1,1,0,9
1385524,1060830,2021-04-22,Senate,"Do pass as amended, but first amend, and re-refer to the Committee on [Appropriations]",4,1,0,0,5
1385524,1075312,2021-05-10,Senate,"Placed on suspense file",7,0,0,0,7
1385526,1035260,2021-03-23,Assembly,"Do pass as amended and be re-referred to the Committee on [Arts, Entertainment, Sports, Tourism, and Internet Media]",8,2,1,0,11
1385526,1062739,2021-04-26,Assembly,"Do pass as amended and be re-referred to the Committee on [Appropriations]",4,1,2,0,7
1385528,1051893,2021-04-13,Assembly,"Do pass and be re-referred to the Committee on [Appropriations]",11,3,1,0,15
1385529,1011730,2021-02-22,Senate,"Do pass, but first be re-referred to the Committee on [Appropriations]",5,0,2,0,7
1385529,1016174,2021-02-25,Senate,"Do pass",6,0,0,0,6
1385529,1018524,2021-03-01,Senate,"Senate 3rd Reading SB7 Atkins et al. Urgency Clause",34,0,5,0,39
1385529,1065097,2021-04-28,Assembly,"Do pass and be re-referred to the Committee on [Appropriations]",9,1,1,0,11
1385529,1073368,2021-05-05,Assembly,"Do pass",16,0,0,0,16
1385529,1075376,2021-05-10,Assembly,"SB 7 Atkins Third Reading Urgency By RIVAS, R",71,2,5,0,78
1385530,1023839,2021-03-08,Senate,"Do pass as amended, but first amend, and re-refer to the Committee on [Appropriations]",11,1,2,0,14
1385531,1026121,2021-03-10,Senate,"Do pass as amended, but first amend, and re-refer to the Committee on [Appropriations]",7,0,0,0,7
1385531,1044946,2021-04-05,Senate,"Placed on suspense file",7,0,0,0,7
1385534,1023848,2021-03-08,Senate,"Do pass, but first be re-referred to the Committee on [Appropriations]",5,0,0,0,5
1385534,1033613,2021-03-22,Senate,"Placed on suspense file",7,0,0,0,7
1385536,984522,2021-01-11,Assembly,"Be adopted. To Consent Calendar",11,0,1,0,12
1385536,988129,2021-01-15,Assembly,"HR 4 Stone Consent Calendar Second Day",66,0,14,0,80
1385537,1054680,2021-04-15,Senate,"Do pass, but first be re-referred to the Committee on [Appropriations]",4,1,0,0,5
1385537,1068241,2021-05-03,Senate,"Placed on suspense file",6,0,1,0,7
1385538,1065311,2021-04-28,Assembly,"Do pass and be re-referred to the Committee on [Appropriations]",7,0,1,0,8
1385539,988126,2021-01-15,Assembly,"AB 80 Ting Assembly Third Reading",48,13,19,0,80
1385539,990807,2021-01-26,Senate,"Do pass",11,0,7,0,18
1385539,1009550,2021-02-18,Senate,"Do pass",17,0,1,0,18
1385539,1056329,2021-04-19,Senate,"Assembly 3rd Reading AB80 Burke et al. By Skinner Urgency Clause",37,0,3,0,40
1385539,1062781,2021-04-26,Assembly,"With recommendation: That Senate amendments be concurred in",9,0,2,0,11
1385539,1062782,2021-04-26,Assembly,"AB 80 BURKE Concurrence in Senate Amendments",75,0,3,0,78
1385541,1066692,2021-04-29,Senate,"Be adopted, but first be re-referred to the Committee on [Elections and Constitutional Amendments] with recommendation: To Consent Calendar",9,0,0,0,9
1385542,1025103,2021-03-09,Senate,"Do pass as amended, but first amend, and re-refer to the Committee on [Appropriations]",9,2,0,0,11
1385542,1033661,2021-03-22,Senate,"Placed on suspense file",7,0,0,0,7
1385543,1036501,2021-03-24,Assembly,"Do pass as amended and be re-referred to the Committee on [Appropriations]",8,1,2,0,11
1385544,1049001,2021-04-08,Assembly,"Do pass as amended and be re-referred to the Committee on [Insurance]",11,0,0,0,11
1385544,1066713,2021-04-29,Assembly,"Do pass and be re-referred to the Committee on [Appropriations] with recommendation: To Consent Calendar",13,0,0,0,13
1385545,1029565,2021-03-16,Senate,"Do pass, but first be re-referred to the Committee on [Public Safety] with the recommendation: To Consent Calendar",11,0,0,0,11
1385545,1064122,2021-04-27,Senate,"Do pass as amended, but first amend, and re-refer to the Committee on [Appropriations]",4,0,1,0,5
1385545,1075268,2021-05-10,Senate,"Placed on suspense file",7,0,0,0,7
1385546,1025114,2021-03-09,Senate,"Do pass, but first be re-referred to the Committee on [Appropriations]",13,0,1,0,14
1385546,1066726,2021-04-29,Senate,"Senate 3rd Reading SB52 Dodd et al",36,0,4,0,40
1385547,1029559,2021-03-16,Senate,"Do pass as amended, but first amend, and re-refer to the Committee on [Environmental Quality]",7,2,0,0,9
1385547,1050772,2021-04-12,Senate,"Do pass, but first be re-referred to the Committee on [Appropriations]",5,1,1,0,7
1385547,1056338,2021-04-19,Senate,"Placed on suspense file",7,0,0,0,7
1385549,1036464,2021-03-24,Assembly,"Do pass as amended and be re-referred to the Committee on [Judiciary]",6,3,2,0,11
1385551,1028422,2021-03-15,Senate,"Do pass, but first be re-referred to the Committee on [Judiciary]",7,0,0,0,7
1385551,1053457,2021-04-13,Senate,"Do pass, but first be re-referred to the Committee on [Appropriations]",9,0,2,0,11
1385551,1068252,2021-05-03,Senate,"Placed on suspense file",6,0,1,0,7
1385552,1029562,2021-03-16,Senate,"Do pass as amended, but first amend, and re-refer to the Committee on [Appropriations]",5,0,0,0,5
1385552,1045006,2021-04-05,Senate,"Placed on suspense file",7,0,0,0,7
1385553,1064120,2021-04-26,Assembly,"Do pass and be re-referred to the Committee on [Appropriations]",6,3,2,0,11
1385555,988130,2021-01-15,Assembly,"AB 83 Ting Assembly Third Reading",48,13,19,0,80
1385555,1009552,2021-02-18,Senate,"Do pass",17,0,1,0,18
1385555,1028430,2021-03-15,Senate,"Do pass",18,0,0,0,18
1385555,1028431,2021-03-15,Senate,"Assembly 3rd Reading AB83 BUDGET (Ting) By Skinner",39,0,1,0,40
1385555,1028432,2021-03-15,Assembly,"AB 83 BUDGET Concurrence in Senate Amendments By TING",75,0,3,0,78
1385556,1059285,2021-04-21,Assembly,"Do pass and be re-referred to the Committee on [Appropriations]",6,0,2,0,8
1385557,1036542,2021-03-24,Assembly,"Do pass as amended and be re-referred to the Committee on [Natural Resources]",8,4,0,0,12
1385557,1053528,2021-04-14,Assembly,"Do pass and be re-referred to the Committee on [Appropriations]",8,0,3,0,11
1385557,1065237,2021-04-28,Assembly,"Do pass",11,4,1,0,16
1385557,1077566,2021-05-13,Assembly,"AB 39 Chau Assembly Third Reading",50,16,12,0,78
1385558,1036546,2021-03-24,Senate,"Do pass, but first be re-referred to the Committee on [Human Services]",5,1,1,0,7
1385558,1046217,2021-04-06,Senate,"Do pass, but first be re-referred to the Committee on [Appropriations]",5,0,0,0,5
1385558,1056425,2021-04-19,Senate,"Placed on suspense file",7,0,0,0,7
1385559,1054754,2021-04-14,Assembly,"Do pass and be re-referred to the Committee on [Transportation]",11,1,1,0,13
1385559,1064158,2021-04-26,Assembly,"Do pass and be re-referred to the Committee on [Appropriations]",11,2,2,0,15
1385560,1037800,2021-03-25,Senate,"Do pass, but first be re-referred to the Committee on [Housing]",5,0,0,0,5
1385560,1066735,2021-04-29,Senate,"Do pass as amended, but first amend, and re-refer to the Committee on [Appropriations]",7,2,0,0,9
1385561,987928,2021-01-14,Senate,"Do pass as amended, but first amend, and re-refer to the Committee on [Appropriations]",4,1,0,0,5
1385561,989382,2021-01-21,Senate,"Do pass",4,2,0,0,6
1385561,992288,2021-01-28,Senate,"Senate 3rd Reading SB29 Umberg et al. Urgency Clause",29,7,3,0,39
1385561,1002171,2021-02-09,Assembly,"Do pass",6,1,0,0,7
1385561,1007213,2021-02-16,Assembly,"SB 29 Umberg Third Reading Urgency By Berman",55,15,9,0,79
1385562,1025088,2021-03-09,Senate,"Do pass as amended, but first amend, and re-refer to the Committee on [Appropriations]",11,0,0,0,11
1385562,1033635,2021-03-22,Senate,"Placed on suspense file",7,0,0,0,7
1385563,1049883,2021-04-08,Assembly,"Do pass and be re-referred to the Committee on [Appropriations] with recommendation: To Consent Calendar",15,0,0,0,15
1385563,1059159,2021-04-21,Assembly,"Do pass. To Consent Calendar",14,0,2,0,16
1385563,1066690,2021-04-29,Assembly,"AB 63 Petrie-Norris Consent Calendar Second Day Regular Session",77,0,1,0,78
1385565,992320,2021-01-28,Assembly,"Be adopted. To Consent Calendar",10,0,2,0,12
1385565,996617,2021-02-04,Assembly,"HR 5 Chau Consent Calendar Second Day Regular Session",72,0,7,0,79
1385566,1026083,2021-03-10,Senate,"Do pass as amended, but first amend, and re-refer to the Committee on [Appropriations]",7,0,0,0,7
1385566,1044950,2021-04-05,Senate,"Placed on suspense file",7,0,0,0,7
1385567,1059292,2021-04-21,Assembly,"Do pass and be re-referred to the Committee on [Education]",8,0,0,0,8
1385567,1065100,2021-04-28,Assembly,"Do pass as amended and be re-referred to the Committee on [Appropriations]",7,0,0,0,7
1385569,1054623,2021-04-14,Assembly,"Do pass and be re-referred to the Committee on [Privacy and Consumer Protection]",11,1,1,0,13
1385569,1060800,2021-04-22,Assembly,"Do pass and be re-referred to the Committee on [Appropriations]",9,2,0,0,11
1385571,1044958,2021-04-05,Senate,"Do pass, but first be re-referred to the Committee on [Environmental Quality]",12,0,2,0,14
1385571,1062761,2021-04-26,Senate,"Do pass, but first be re-referred to the Committee on [Appropriations]",6,0,1,0,7
1385572,1045017,2021-04-05,Senate,"Senate 3rd Reading SCR2 Umberg et al",38,0,2,0,40
1385572,1066676,2021-04-29,Assembly,"Be adopted. To Consent Calendar",9,0,3,0,12
1385572,1074135,2021-05-06,Assembly,"SCR 2 Umberg Consent Calendar Second Day Regular Session",77,0,1,0,78
1385573,1035238,2021-03-23,Senate,"Do pass as amended, but first amend, and re-refer to the Committee on [Judiciary]",9,3,3,0,15
1385573,1053466,2021-04-13,Senate,"Do pass as amended, but first amend, and re-refer to the Committee on [Appropriations]",8,1,2,0,11
1385573,1068221,2021-05-03,Senate,"Placed on suspense file",6,0,1,0,7
1385574,1025124,2021-03-09,Senate,"Do pass, but first be re-referred to the Committee on [Judiciary]",4,0,0,0,4
1385574,1053469,2021-04-13,Senate,"Do pass as amended, but first amend, and re-refer to the Committee on [Appropriations]",8,1,2,0,11
1385574,1068161,2021-05-03,Senate,"Placed on suspense file",6,0,1,0,7
1385576,1047527,2021-04-07,Assembly,"Do pass and be re-referred to the Committee on [Appropriations]",7,0,2,0,9
1385577,1052016,2021-04-13,Senate,"Do pass, but first be re-referred to the Committee on [Appropriations] with the recommendation: To Consent Calendar",16,0,1,0,17
1385577,1068262,2021-05-03,Senate,"Placed on suspense file",6,0,1,0,7
1385579,1051892,2021-04-13,Assembly,"Be adopted. To third reading",7,3,1,0,11
1385580,1060932,2021-04-22,Assembly,"Do pass and be re-referred to the Committee on [Health]",20,0,2,0,22
1385580,1064062,2021-04-27,Assembly,"Do pass as amended and be re-referred to the Committee on [Appropriations]",15,0,0,0,15
1385583,1054607,2021-04-14,Assembly,"Do pass and be re-referred to the Committee on [Local Government]",9,1,3,0,13
1385583,1065257,2021-04-28,Assembly,"Do pass and be re-referred to the Committee on [Appropriations]",5,2,1,0,8
1385584,1052007,2021-04-13,Assembly,"Do pass and be re-referred to the Committee on [Appropriations]",15,0,0,0,15
1385585,1059313,2021-04-21,Assembly,"Do pass as amended, and be re-referred to the Committee on [Appropriations] with recommendation: To Consent Calendar",15,0,0,0,15
1385585,1076961,2021-05-12,Assembly,"Do pass. To Consent Calendar",16,0,0,0,16
1385586,988136,2021-01-15,Assembly,"AB 85 Ting Assembly Third Reading",48,13,19,0,80
1385586,1009534,2021-02-18,Senate,"Do pass",12,3,3,0,18
1385586,1011802,2021-02-22,Senate,"Assembly 3rd Reading AB85 BUDGET (Ting) By Skinner",30,8,1,0,39
1385586,1011803,2021-02-22,Assembly,"AB 85 BUDGET Assembly Third Reading By TING",64,3,12,0,79
1385586,1013310,2021-02-22,Assembly,"AB 85 BUDGET Concurrence in Senate Amendments By TING",64,3,12,0,79
1385587,1026116,2021-03-10,Senate,"Do pass, but first be re-referred to the Committee on [Judiciary]",6,0,1,0,7
1385587,1035236,2021-03-23,Senate,"Do pass, but first be re-referred to the Committee on [Appropriations] with the recommendation: To Consent Calendar",11,0,0,0,11
1385587,1045002,2021-04-05,Senate,"Placed on suspense file",7,0,0,0,7
1385588,1035243,2021-03-22,Assembly,"Do pass and be re-referred to the Committee on [Appropriations]",13,1,1,0,15
1385588,1053536,2021-04-14,Assembly,"Do pass",15,0,1,0,16
1385588,1060894,2021-04-22,Assembly,"AB 3 Fong Assembly Third Reading",68,6,5,0,79
1385589,1074184,2021-05-06,Senate,"Do pass as amended",5,0,0,0,5
1385591,1053532,2021-04-14,Assembly,"Do pass and be re-referred to the Committee on [Appropriations]",11,0,0,0,11
1385592,1065302,2021-04-28,Assembly,"Do pass and be re-referred to the Committee on [Appropriations]",7,0,0,0,7
1385593,1025090,2021-03-09,Senate,"Do pass, but first be re-referred to the Committee on [Appropriations]",11,0,0,0,11
1385593,1044987,2021-04-05,Senate,"Senate 3rd Reading SB24 Caballero et al",38,0,2,0,40
1385594,1026089,2021-03-10,Senate,"Do pass as amended, but first amend, and re-refer to the Committee on [Appropriations]",11,0,0,0,11
1385594,1056392,2021-04-19,Senate,"Placed on suspense file",7,0,0,0,7
1385595,1036481,2021-03-24,Assembly,"Do pass as amended and be re-referred to the Committee on [Appropriations]",7,0,0,0,7
1385753,1064007,2021-04-27,Assembly,"Do pass and be re-referred to the Committee on [Appropriations]",13,1,1,0,15
1385755,1051949,2021-04-13,Senate,"Do pass, but first be re-referred to the Committee on [Appropriations]",16,0,1,0,17
1385755,1075329,2021-05-10,Senate,"Placed on suspense file",7,0,0,0,7
1385756,1030819,2021-03-17,Senate,"Do pass, but first be re-referred to the Committee on [Appropriations]",5,2,0,0,7
1385756,1044951,2021-04-05,Senate,"Placed on suspense file",7,0,0,0,7
1385862,1057725,2021-04-20,Assembly,"Do pass and be re-referred to the Committee on [Health] with recommendation: To Consent Calendar",7,0,0,0,7
1385862,1064009,2021-04-27,Assembly,"Do pass as amended, and be re-referred to the Committee on [Appropriations] with recommendation: To Consent Calendar",15,0,0,0,15
1385863,1048960,2021-04-07,Assembly,"Do pass and be re-referred to the Committee on [Higher Education]",7,0,0,0,7
1385863,1061001,2021-04-22,Assembly,"Do pass as amended and be re-referred to the Committee on [Appropriations]",12,0,0,0,12
1385864,1060854,2021-04-22,Assembly,"Be adopted. To third reading",12,0,0,0,12
1385866,1025087,2021-03-09,Senate,"Do pass and be ordered to the Consent Calendar",4,0,0,0,4
1385866,1033614,2021-03-22,Senate,"Consent Calendar SB71 McGuire",37,0,3,0,40
1386879,1048882,2021-04-08,Senate,"Do pass, but first be re-referred to the Committee on [Appropriations] with the recommendation: To Consent Calendar",12,0,0,0,12
1386879,1068284,2021-05-03,Senate,"Placed on suspense file",6,0,1,0,7
1386880,1025132,2021-03-09,Senate,"Do pass, but first be re-referred to the Committee on [Appropriations]",3,1,0,0,4
1386880,1050842,2021-04-12,Senate,"Senate 3rd Reading SB73 Wiener et al",25,10,5,0,40
1387073,1047488,2021-04-07,Assembly,"Do pass and be re-referred to the Committee on [Appropriations]",8,0,1,0,9
1387074,1049014,2021-04-07,Assembly,"Do pass as amended and be re-referred to the Committee on [Appropriations]",5,2,0,0,7
1387075,1036495,2021-03-24,Assembly,"Do pass as amended and be re-referred to the Committee on [Education]",12,0,0,0,12
1387077,1036470,2021-03-24,Assembly,"Do pass and be re-referred to the Committee on [Appropriations]",7,0,0,0,7
1387077,1047493,2021-04-07,Assembly,"Do pass as amended",14,0,2,0,16
1387077,1054727,2021-04-15,Assembly,"AB 104 Lorena Gonzalez Third Reading Urgency",77,0,1,0,78
1387347,1066753,2021-04-29,Assembly,"Do pass and be re-referred to the Committee on [Appropriations]",5,1,1,0,7
1387349,1074140,2021-05-06,Assembly,"Be adopted. To third reading",11,0,1,0,12
1387685,1046101,2021-04-05,Senate,"Do pass, but first be re-referred to the Committee on [Judiciary] with the recommendation: To Consent Calendar",5,0,0,0,5
1387685,1059290,2021-04-20,Senate,"Do pass, but first be re-referred to the Committee on [Appropriations] with the recommendation: To Consent Calendar",11,0,0,0,11
1387685,1068260,2021-05-03,Senate,"Placed on suspense file",6,0,1,0,7
1387688,1048970,2021-04-08,Senate,"Do pass, but first be re-referred to the Committee on [Transportation] with the recommendation: To Consent Calendar",5,0,0,0,5
1387688,1064137,2021-04-27,Senate,"Do pass and be ordered to the Consent Calendar",15,0,2,0,17
1387688,1068198,2021-05-03,Senate,"Consent Calendar SB79 Nielsen Urgency Clause",36,0,4,0,40
1387689,1029564,2021-03-16,Senate,"Do pass as amended, but first amend, and re-refer to the Committee on [Health] with the recommendation: To Consent Calendar",9,0,0,0,9
1387689,1053418,2021-04-14,Senate,"Do pass as amended, but first amend, and re-refer to the Committee on [Appropriations]",11,0,0,0,11
1387689,1068246,2021-05-03,Senate,"Placed on suspense file",6,0,1,0,7
1387690,1029583,2021-03-16,Senate,"Do pass, but first be re-referred to the Committee on [Appropriations]",4,0,1,0,5
1387690,1068173,2021-05-03,Senate,"Placed on suspense file",6,0,1,0,7
1387691,1029574,2021-03-16,Senate,"Do pass as amended, but first amend, and re-refer to the Committee on [Appropriations]",4,1,0,0,5
1387691,1044963,2021-04-05,Senate,"Placed on suspense file",7,0,0,0,7
1387692,1029582,2021-03-16,Senate,"Do pass, but first be re-referred to the Committee on [Governance and Finance]",9,0,0,0,9
1387693,1029572,2021-03-16,Senate,"Do pass as amended, but first amend, and re-refer to the Committee on [Appropriations]",7,1,1,0,9
1387693,1066764,2021-04-29,Senate,"Senate 3rd Reading SB84 Hurtado",31,3,6,0,40
1388067,1064118,2021-04-27,Assembly,"Do pass as amended and be re-referred to the Committee on [Appropriations]",6,0,1,0,7
1388068,1035209,2021-03-23,Assembly,"Do pass as amended and be re-referred to the Committee on [Military and Veterans Affairs]",17,0,2,0,19
1388068,1065166,2021-04-28,Assembly,"Do pass and be re-referred to the Committee on [Appropriations]",11,0,0,0,11
1388071,989383,2021-01-21,Senate,"Senate 3rd Reading SB85 Skinner",22,2,15,0,39
1388071,1050822,2021-04-12,Senate,"Unfinished Business SB85 B. & F.R. (Skinner) Concurrence",39,0,1,0,40
1388071,1053417,2021-04-12,Assembly,"SB 85 B. & F. R. Senate Third Reading By TING",74,0,4,0,78
1388072,989387,2021-01-21,Senate,"Senate 3rd Reading SB86 Skinner",25,1,13,0,39
1388072,1053503,2021-04-12,Assembly,"SB 86 B. & F. R. Senate Third Reading By TING",73,0,5,0,78
1388072,1054634,2021-04-15,Senate,"Unfinished Business SB86 B. & F.R. (Skinner) Concurrence",30,0,10,0,40
1388073,989389,2021-01-21,Senate,"Senate 3rd Reading SB87 Skinner",22,2,15,0,39
1388073,1011718,2021-02-22,Senate,"Unfinished Business SB87 Caballero et al. Concurrence",38,0,1,0,39
1388073,1011719,2021-02-22,Assembly,"SB 87 Caballero Senate Third Reading By TING",77,0,2,0,79
1388074,989386,2021-01-21,Senate,"Senate 3rd Reading SB88",22,2,15,0,39
1388074,1011751,2021-02-22,Senate,"Unfinished Business SB88 B. & F.R. (Skinner) Concurrence",31,0,8,0,39
1388074,1011752,2021-02-22,Assembly,"SB 88 B. & F. R. Senate Third Reading By TING",67,1,11,0,79
1388075,989390,2021-01-21,Senate,"Senate 3rd Reading SB89",22,2,15,0,39
1388075,992302,2021-01-28,Senate,"Unfinished Business SB89 Skinner Concurrence",37,0,2,0,39
1388075,992303,2021-01-28,Assembly,"SB 89 Skinner Senate Third Reading By REYES",75,0,5,0,80
1388077,989384,2021-01-21,Senate,"Senate 3rd Reading SB91",22,2,15,0,39
1388077,992318,2021-01-28,Senate,"Unfinished Business SB91 B. & F.R. (Skinner) Concurrence",34,0,5,0,39
1388077,992319,2021-01-28,Assembly,"SB 91 B. & F. R. Senate Third Reading By REYES",72,1,7,0,80
1388078,989391,2021-01-21,Senate,"Senate 3rd Reading SB92",22,2,15,0,39
1388078,1066799,2021-04-29,Assembly,"SB 92 B. & F. R. Senate Third Reading",56,17,5,0,78
1388078,1068281,2021-05-03,Senate,"Unfinished Business SB92 B. & F.R. (Skinner) Concurrence",28,8,4,0,40
1388079,989397,2021-01-21,Senate,"Senate 3rd Reading SB93",22,2,15,0,39
1388079,1053473,2021-04-12,Assembly,"SB 93 B. & F. R. Senate Third Reading By TING",54,19,5,0,78
1388079,1054642,2021-04-15,Senate,"Unfinished Business SB93 B. & F.R. (Skinner) Concurrence",25,11,4,0,40
1388080,989385,2021-01-21,Senate,"Senate 3rd Reading SB94",22,2,15,0,39
1388080,1011714,2021-02-22,Senate,"Unfinished Business SB94 Skinner Concurrence",38,0,1,0,39
1388080,1011715,2021-02-22,Assembly,"SB 94 Skinner Senate Third Reading By TING",77,0,2,0,79
1388081,989381,2021-01-21,Senate,"Senate 3rd Reading SB95",22,2,15,0,39
1388081,1028391,2021-03-15,Assembly,"SB 95 Skinner Senate Third Reading By TING",57,19,2,0,78
1388081,1031884,2021-03-18,Senate,"Unfinished Business SB95 Skinner Concurrence",29,8,3,0,40
1388315,1048913,2021-04-08,Assembly,"Do pass as amended and be re-referred to the Committee on [Insurance]",10,0,1,0,11
1388315,1066682,2021-04-29,Assembly,"Do pass and be re-referred to the Committee on [Appropriations]",13,0,0,0,13
1388317,1035216,2021-03-23,Assembly,"Do pass as amended, and be re-referred to the Committee on [Appropriations] with recommendation: To Consent Calendar",15,0,0,0,15
1388319,1052017,2021-04-13,Assembly,"Do pass and be re-referred to the Committee on [Appropriations]",15,0,0,0,15
1388500,1054683,2021-04-15,Assembly,"Do pass as amended and be re-referred to the Committee on [Local Government]",5,2,1,0,8
1388502,1044974,2021-04-05,Assembly,"Do pass and be re-referred to the Committee on [Appropriations]",11,0,4,0,15
1388503,1044959,2021-04-05,Assembly,"Do pass and be re-referred to the Committee on [Appropriations]",6,0,1,0,7
1388505,1048880,2021-04-08,Assembly,"Do pass and be re-referred to the Committee on [Appropriations]",22,0,0,0,22
1388505,1065153,2021-04-28,Assembly,"Do pass. To Consent Calendar",16,0,0,0,16
1388505,1074156,2021-05-06,Assembly,"AB 120 Salas Consent Calendar Second Day",77,0,1,0,78
1388507,1035251,2021-03-22,Assembly,"Do pass as amended and be re-referred to the Committee on [Appropriations]",10,4,1,0,15
1388507,1053489,2021-04-14,Assembly,"Do pass",12,3,1,0,16
1388507,1060891,2021-04-22,Assembly,"AB 122 Boerner Horvath Assembly Third Reading",53,11,15,0,79
1388508,1054747,2021-04-15,Assembly,"Do pass and be re-referred to the Committee on [Appropriations]",10,1,2,0,13
1388509,1059167,2021-04-20,Assembly,"Do pass and be re-referred to the Committee on [Appropriations]",6,2,0,0,8
1388510,1054713,2021-04-15,Assembly,"Do pass and be re-referred to the Committee on [Natural Resources]",10,0,1,0,11
1388511,1036442,2021-03-24,Assembly,"Do pass as amended, and be re-referred to the Committee on [Appropriations] with recommendation: To Consent Calendar",7,0,0,0,7
1388512,1059234,2021-04-20,Assembly,"Do pass",6,0,2,0,8
1388512,1068180,2021-05-03,Assembly,"AB 127 Kamlager Assembly Third Reading By STONE",57,8,13,0,78
1388733,1026133,2021-03-10,Senate,"Do pass, but first be re-referred to the Committee on [Appropriations] with the recommendation: To Consent Calendar",7,0,0,0,7
1388733,1033683,2021-03-22,Senate,"Placed on suspense file",7,0,0,0,7
1388849,1025146,2021-03-09,Senate,"Do pass, but first be re-referred to the Committee on [Appropriations]",3,0,1,0,4
1388849,1033624,2021-03-22,Senate,"Placed on suspense file",7,0,0,0,7
1389028,1035259,2021-03-23,Senate,"Do pass as amended, but first amend, and re-refer to the Committee on [Appropriations] with the recommendation: To Consent Calendar",5,0,0,0,5
1389028,1056375,2021-04-19,Senate,"Placed on suspense file",7,0,0,0,7
1389029,1056413,2021-04-19,Senate,"Do pass, but first be re-referred to the Committee on [Appropriations]",12,0,2,0,14
1389029,1068266,2021-05-03,Senate,"Placed on suspense file",6,0,1,0,7
1391001,1025092,2021-03-09,Senate,"Do pass, but first be re-referred to the Committee on [Appropriations] with the recommendation: To Consent Calendar",4,0,0,0,4
1391001,1033654,2021-03-22,Senate,"Placed on suspense file",7,0,0,0,7
1391785,1044964,2021-04-05,Senate,"Do pass as amended, but first amend, and re-refer to the Committee on [Governmental Organization]",6,7,1,0,14
1391785,1044965,2021-04-05,Senate,"[Final] hearing set for [04-05-2021]: Failed passage in Committee. Reconsideration granted",14,0,0,0,14
1394324,1028419,2021-03-15,Senate,"Do pass as amended, but first amend, and re-refer to the Committee on [Appropriations]",5,0,0,0,5
1394324,1062799,2021-04-26,Senate,"Senate 3rd Reading SB103 Dodd",38,0,2,0,40
1394325,1037808,2021-03-25,Senate,"Do pass as amended, but first amend, and re-refer to the Committee on [Appropriations]",5,0,0,0,5
1394325,1056352,2021-04-19,Senate,"Placed on suspense file",7,0,0,0,7
1394327,1065148,2021-04-28,Senate,"Do pass as amended, but first amend, and re-refer to the Committee on [Appropriations]",11,0,0,0,11
1394328,1025111,2021-03-09,Senate,"Do pass, but first be re-referred to the Committee on [Appropriations]",4,0,0,0,4
1394329,1035246,2021-03-23,Senate,"Do pass, but first be re-referred to the Committee on [Rules]",4,0,1,0,5
1394329,1068267,2021-05-03,Senate,"Placed on suspense file",6,0,1,0,7
1395390,1025106,2021-03-09,Senate,"Do pass, but first be re-referred to the Committee on [Appropriations]",13,0,1,0,14
1395390,1033618,2021-03-22,Senate,"Placed on suspense file",7,0,0,0,7
1395391,1059325,2021-04-21,Senate,"Do pass, but first be re-referred to the Committee on [Appropriations]",10,0,1,0,11
1395392,988122,2021-01-15,Senate,"Senate 3rd Reading SCR6 Bradford",30,0,9,0,39
1395392,992310,2021-01-28,Assembly,"Be adopted. To Consent Calendar",10,0,2,0,12
1395392,996629,2021-02-04,Assembly,"SCR 6 Bradford Consent Calendar Second Day Regular Session",72,0,7,0,79
1398145,1016207,2021-02-25,Assembly,"AB 128 BUDGET Assembly Third Reading By TING",56,18,5,0,79
1398146,1016188,2021-02-25,Assembly,"AB 129 BUDGET Assembly Third Reading By TING",56,18,5,0,79
1398147,1016252,2021-02-25,Assembly,"AB 130 BUDGET Assembly Third Reading By TING",56,18,5,0,79
1398148,1016190,2021-02-25,Assembly,"AB 131 BUDGET Assembly Third Reading By TING",56,18,5,0,79
1398149,1016271,2021-02-25,Assembly,"AB 132 BUDGET Assembly Third Reading By TING",56,18,5,0,79
1398150,1016231,2021-02-25,Assembly,"AB 133 BUDGET Assembly Third Reading By TING",56,18,5,0,79
1398151,1016226,2021-02-25,Assembly,"AB 134 BUDGET Assembly Third Reading By TING",56,18,5,0,79
1398152,1016253,2021-02-25,Assembly,"AB 135 BUDGET Assembly Third Reading By TING",56,18,5,0,79
1398153,1016214,2021-02-25,Assembly,"AB 136 BUDGET Assembly Third Reading By TING",56,18,5,0,79
1398154,1016165,2021-02-25,Assembly,"AB 137 BUDGET Assembly Third Reading By TING",56,18,5,0,79
1398155,1016260,2021-02-25,Assembly,"AB 138 BUDGET Assembly Third Reading By TING",56,18,5,0,79
1398156,1016274,2021-02-25,Assembly,"AB 139 BUDGET Assembly Third Reading By TING",56,18,5,0,79
1398157,1016168,2021-02-25,Assembly,"AB 140 BUDGET Assembly Third Reading By TING",56,18,5,0,79
1398158,1016251,2021-02-25,Assembly,"AB 141 BUDGET Assembly Third Reading By TING",56,18,5,0,79
1398159,1016236,2021-02-25,Assembly,"AB 142 BUDGET Assembly Third Reading By TING",56,18,5,0,79
1398160,1016232,2021-02-25,Assembly,"AB 143 BUDGET Assembly Third Reading By TING",56,18,5,0,79
1398161,1016270,2021-02-25,Assembly,"AB 144 BUDGET Assembly Third Reading By TING",56,18,5,0,79
1398162,1016178,2021-02-25,Assembly,"AB 145 BUDGET Assembly Third Reading By TING",56,18,5,0,79
1398163,1016263,2021-02-25,Assembly,"AB 146 BUDGET Assembly Third Reading By TING",56,18,5,0,79
1398164,1016262,2021-02-25,Assembly,"AB 147 BUDGET Assembly Third Reading By TING",56,18,5,0,79
1398165,1016220,2021-02-25,Assembly,"AB 148 BUDGET Assembly Third Reading By TING",56,18,5,0,79
1398166,1016243,2021-02-25,Assembly,"AB 149 BUDGET Assembly Third Reading By TING",56,18,5,0,79
1398167,1016255,2021-02-25,Assembly,"AB 150 BUDGET Assembly Third Reading By TING",56,18,5,0,79
1398168,1016240,2021-02-25,Assembly,"AB 151 BUDGET Assembly Third Reading By TING",56,18,5,0,79
1398169,1016191,2021-02-25,Assembly,"AB 152 BUDGET Assembly Third Reading By TING",56,18,5,0,79
1398170,1016234,2021-02-25,Assembly,"AB 153 BUDGET Assembly Third Reading By TING",56,18,5,0,79
1398171,1016266,2021-02-25,Assembly,"AB 154 BUDGET Assembly Third Reading By TING",56,18,5,0,79
1398172,1016222,2021-02-25,Assembly,"AB 155 BUDGET Assembly Third Reading By TING",56,18,5,0,79
1398173,1016250,2021-02-25,Assembly,"AB 156 BUDGET Assembly Third Reading By TING",56,18,5,0,79
1398174,1016180,2021-02-25,Assembly,"AB 157 BUDGET Assembly Third Reading By TING",56,18,5,0,79
1398175,1016242,2021-02-25,Assembly,"AB 158 BUDGET Assembly Third Reading By TING",56,18,5,0,79
1398176,1016201,2021-02-25,Assembly,"AB 159 BUDGET Assembly Third Reading By TING",56,18,5,0,79
1398177,1016257,2021-02-25,Assembly,"AB 160 BUDGET Assembly Third Reading By TING",56,18,5,0,79
1398178,1016229,2021-02-25,Assembly,"AB 161 BUDGET Assembly Third Reading By TING",56,18,5,0,79
1398179,1016161,2021-02-25,Assembly,"AB 162 BUDGET Assembly Third Reading By TING",56,18,5,0,79
1398180,1016269,2021-02-25,Assembly,"AB 163 BUDGET Assembly Third Reading By TING",56,18,5,0,79
1398181,1016273,2021-02-25,Assembly,"AB 164 BUDGET Assembly Third Reading By TING",56,18,5,0,79
1398182,1016247,2021-02-25,Assembly,"AB 165 BUDGET Assembly Third Reading By TING",56,18,5,0,79
1398183,1016170,2021-02-25,Assembly,"AB 166 BUDGET Assembly Third Reading By TING",56,18,5,0,79
1398184,1016235,2021-02-25,Assembly,"AB 167 BUDGET Assembly Third Reading By TING",56,18,5,0,79
1398185,1016187,2021-02-25,Assembly,"AB 168 BUDGET Assembly Third Reading By TING",56,18,5,0,79
1398186,1016172,2021-02-25,Assembly,"AB 169 BUDGET Assembly Third Reading By TING",56,18,5,0,79
1398187,1016275,2021-02-25,Assembly,"AB 170 BUDGET Assembly Third Reading By TING",56,18,5,0,79
1398188,1016167,2021-02-25,Assembly,"AB 171 BUDGET Assembly Third Reading By TING",56,18,5,0,79
1398189,1016258,2021-02-25,Assembly,"AB 172 BUDGET Assembly Third Reading By TING",56,18,5,0,79
1398190,1016219,2021-02-25,Assembly,"AB 173 BUDGET Assembly Third Reading By TING",56,18,5,0,79
1398191,1016171,2021-02-25,Assembly,"AB 174 BUDGET Assembly Third Reading By TING",56,18,5,0,79
1398192,1016205,2021-02-25,Assembly,"AB 175 BUDGET Assembly Third Reading By TING",56,18,5,0,79
1398193,1016173,2021-02-25,Assembly,"AB 176 BUDGET Assembly Third Reading By TING",56,18,5,0,79
1398194,1016256,2021-02-25,Assembly,"AB 177 BUDGET Assembly Third Reading By TING",56,18,5,0,79
1398195,1016239,2021-02-25,Assembly,"AB 178 BUDGET Assembly Third Reading By TING",56,18,5,0,79
1398196,1016216,2021-02-25,Assembly,"AB 179 BUDGET Assembly Third Reading By TING",56,18,5,0,79
1398197,1016151,2021-02-25,Assembly,"AB 180 BUDGET Assembly Third Reading By TING",56,18,5,0,79
1398198,1016238,2021-02-25,Assembly,"AB 181 BUDGET Assembly Third Reading By TING",56,18,5,0,79
1398199,1016245,2021-02-25,Assembly,"AB 182 BUDGET Assembly Third Reading By TING",56,18,5,0,79
1398200,1016209,2021-02-25,Assembly,"AB 183 BUDGET Assembly Third Reading By TING",56,18,5,0,79
1398201,1016237,2021-02-25,Assembly,"AB 184 BUDGET Assembly Third Reading By TING",56,18,5,0,79
1398202,1016186,2021-02-25,Assembly,"AB 185 BUDGET Assembly Third Reading By TING",56,18,5,0,79
1398203,1016261,2021-02-25,Assembly,"AB 186 BUDGET Assembly Third Reading By TING",56,18,5,0,79
1398204,1016225,2021-02-25,Assembly,"AB 187 BUDGET Assembly Third Reading By TING",56,18,5,0,79
1398205,1016210,2021-02-25,Assembly,"AB 188 BUDGET Assembly Third Reading By TING",56,18,5,0,79
1398206,1016189,2021-02-25,Assembly,"AB 189 BUDGET Assembly Third Reading By TING",56,18,5,0,79
1398207,1016185,2021-02-25,Assembly,"AB 190 BUDGET Assembly Third Reading By TING",56,18,5,0,79
1398208,1016254,2021-02-25,Assembly,"AB 191 BUDGET Assembly Third Reading By TING",56,18,5,0,79
1398209,1016248,2021-02-25,Assembly,"AB 192 BUDGET Assembly Third Reading By TING",56,18,5,0,79
1398210,1016206,2021-02-25,Assembly,"AB 193 BUDGET Assembly Third Reading By TING",56,18,5,0,79
1398211,1016196,2021-02-25,Assembly,"AB 194 BUDGET Assembly Third Reading By TING",56,18,5,0,79
1398212,1016181,2021-02-25,Assembly,"AB 195 BUDGET Assembly Third Reading By TING",56,18,5,0,79
1398213,1016228,2021-02-25,Assembly,"AB 196 BUDGET Assembly Third Reading By TING",56,18,5,0,79
1398214,1016203,2021-02-25,Assembly,"AB 197 BUDGET Assembly Third Reading By TING",56,18,5,0,79
1398215,1016267,2021-02-25,Assembly,"AB 198 BUDGET Assembly Third Reading By TING",56,18,5,0,79
1398216,1016233,2021-02-25,Assembly,"AB 199 BUDGET Assembly Third Reading By TING",56,18,5,0,79
1398217,1016211,2021-02-25,Assembly,"AB 200 BUDGET Assembly Third Reading By TING",56,18,5,0,79
1398218,1016197,2021-02-25,Assembly,"AB 201 BUDGET Assembly Third Reading By TING",56,18,5,0,79
1398219,1016177,2021-02-25,Assembly,"AB 202 BUDGET Assembly Third Reading By TING",56,18,5,0,79
1398220,1016162,2021-02-25,Assembly,"AB 203 BUDGET Assembly Third Reading By TING",56,18,5,0,79
1398221,1016259,2021-02-25,Assembly,"AB 204 BUDGET Assembly Third Reading By TING",56,18,5,0,79
1398222,1016182,2021-02-25,Assembly,"AB 205 BUDGET Assembly Third Reading By TING",56,18,5,0,79
1398223,1016202,2021-02-25,Assembly,"AB 206 BUDGET Assembly Third Reading By TING",56,18,5,0,79
1398224,1016163,2021-02-25,Assembly,"AB 207 BUDGET Assembly Third Reading By TING",56,18,5,0,79
1398225,1016160,2021-02-25,Assembly,"AB 208 BUDGET Assembly Third Reading By TING",56,18,5,0,79
1398226,1016166,2021-02-25,Assembly,"AB 209 BUDGET Assembly Third Reading By TING",56,18,5,0,79
1398227,1016194,2021-02-25,Assembly,"AB 210 BUDGET Assembly Third Reading By TING",56,18,5,0,79
1398228,1016164,2021-02-25,Assembly,"AB 211 BUDGET Assembly Third Reading By TING",56,18,5,0,79
1398229,1016208,2021-02-25,Assembly,"AB 212 BUDGET Assembly Third Reading By TING",56,18,5,0,79
1398230,1016212,2021-02-25,Assembly,"AB 213 BUDGET Assembly Third Reading By TING",56,18,5,0,79
1398230,1050792,2021-04-12,Senate,"Do pass",14,0,4,0,18
1398232,984520,2021-01-11,Assembly,"Be adopted. To third reading",11,0,1,0,12
1398234,1011768,2021-02-22,Senate,"Senate 3rd Reading SB113 Skinner",29,8,2,0,39
1398235,1011735,2021-02-22,Senate,"Senate 3rd Reading SB114 Skinner",29,8,2,0,39
1398236,1011733,2021-02-22,Senate,"Senate 3rd Reading SB115",29,8,2,0,39
1398237,1011734,2021-02-22,Senate,"Senate 3rd Reading SB116",29,8,2,0,39
1398238,1011785,2021-02-22,Senate,"Senate 3rd Reading SB117",29,8,2,0,39
1398239,1011787,2021-02-22,Senate,"Senate 3rd Reading SB118",29,8,2,0,39
1398240,1011736,2021-02-22,Senate,"Senate 3rd Reading SB119",29,8,2,0,39
1398241,1011704,2021-02-22,Senate,"Senate 3rd Reading SB120",29,8,2,0,39
1398242,1011725,2021-02-22,Senate,"Senate 3rd Reading SB121",29,8,2,0,39
1398243,1011761,2021-02-22,Senate,"Senate 3rd Reading SB122",29,8,2,0,39
1398244,1011749,2021-02-22,Senate,"Senate 3rd Reading SB123",29,8,2,0,39
1398245,1011777,2021-02-22,Senate,"Senate 3rd Reading SB124",29,8,2,0,39
1398246,1011760,2021-02-22,Senate,"Senate 3rd Reading SB125",29,8,2,0,39
1398247,1011810,2021-02-22,Senate,"Senate 3rd Reading SB126",29,8,2,0,39
1398248,1011837,2021-02-22,Senate,"Senate 3rd Reading SB127",29,8,2,0,39
1398249,1011775,2021-02-22,Senate,"Senate 3rd Reading SB128",29,8,2,0,39
1398250,1011786,2021-02-22,Senate,"Senate 3rd Reading SB129",29,8,2,0,39
1398251,1011794,2021-02-22,Senate,"Senate 3rd Reading SB130",29,8,2,0,39
1398252,1011755,2021-02-22,Senate,"Senate 3rd Reading SB131",29,8,2,0,39
1398253,1011745,2021-02-22,Senate,"Senate 3rd Reading SB132",29,8,2,0,39
1398254,1011703,2021-02-22,Senate,"Senate 3rd Reading SB133",29,8,2,0,39
1398255,1011744,2021-02-22,Senate,"Senate 3rd Reading SB134",29,8,2,0,39
1398256,1011829,2021-02-22,Senate,"Senate 3rd Reading SB135",29,8,2,0,39
1398257,1011824,2021-02-22,Senate,"Senate 3rd Reading SB136",29,8,2,0,39
1398258,1011766,2021-02-22,Senate,"Senate 3rd Reading SB137",29,8,2,0,39
1398259,1011801,2021-02-22,Senate,"Senate 3rd Reading SB138",29,8,2,0,39
1398260,1011746,2021-02-22,Senate,"Senate 3rd Reading SB139",29,8,2,0,39
1398261,1011750,2021-02-22,Senate,"Senate 3rd Reading SB140",29,8,2,0,39
1398262,1011792,2021-02-22,Senate,"Senate 3rd Reading SB141",29,8,2,0,39
1398263,1011748,2021-02-22,Senate,"Senate 3rd Reading SB142",29,8,2,0,39
1398264,1011747,2021-02-22,Senate,"Senate 3rd Reading SB143",29,8,2,0,39
1398265,1011770,2021-02-22,Senate,"Senate 3rd Reading SB144",29,8,2,0,39
1398266,1011738,2021-02-22,Senate,"Senate 3rd Reading SB145",29,8,2,0,39
1398267,1011717,2021-02-22,Senate,"Senate 3rd Reading SB146",29,8,2,0,39
1398268,1011815,2021-02-22,Senate,"Senate 3rd Reading SB147",29,8,2,0,39
1398269,1011699,2021-02-22,Senate,"Senate 3rd Reading SB148",29,8,2,0,39
1398270,1011806,2021-02-22,Senate,"Senate 3rd Reading SB149",29,8,2,0,39
1398271,1011804,2021-02-22,Senate,"Senate 3rd Reading SB150",29,8,2,0,39
1398272,1011741,2021-02-22,Senate,"Senate 3rd Reading SB151",29,8,2,0,39
1398273,1011740,2021-02-22,Senate,"Senate 3rd Reading SB152",29,8,2,0,39
1398274,1011808,2021-02-22,Senate,"Senate 3rd Reading SB153",29,8,2,0,39
1398275,1011821,2021-02-22,Senate,"Senate 3rd Reading SB154",29,8,2,0,39
1398276,1011798,2021-02-22,Senate,"Senate 3rd Reading SB155",29,8,2,0,39
1398277,1011712,2021-02-22,Senate,"Senate 3rd Reading SB156",29,8,2,0,39
1398278,1011813,2021-02-22,Senate,"Senate 3rd Reading SB157",29,8,2,0,39
1398279,1011789,2021-02-22,Senate,"Senate 3rd Reading SB158",29,8,2,0,39
1398280,1011778,2021-02-22,Senate,"Senate 3rd Reading SB159",29,8,2,0,39
1398281,1011799,2021-02-22,Senate,"Senate 3rd Reading SB160",29,8,2,0,39
1398282,1011706,2021-02-22,Senate,"Senate 3rd Reading SB161",29,8,2,0,39
1398283,1011731,2021-02-22,Senate,"Senate 3rd Reading SB162",29,8,2,0,39
1398284,1011727,2021-02-22,Senate,"Senate 3rd Reading SB163",29,8,2,0,39
1398285,1011783,2021-02-22,Senate,"Senate 3rd Reading SB164",29,8,2,0,39
1398286,1011729,2021-02-22,Senate,"Senate 3rd Reading SB165",29,8,2,0,39
1398287,1011832,2021-02-22,Senate,"Senate 3rd Reading SB166",29,8,2,0,39
1398288,1011800,2021-02-22,Senate,"Senate 3rd Reading SB167",29,8,2,0,39
1398289,1011701,2021-02-22,Senate,"Senate 3rd Reading SB168",29,8,2,0,39
1398290,1011739,2021-02-22,Senate,"Senate 3rd Reading SB169",29,8,2,0,39
1398291,1011754,2021-02-22,Senate,"Senate 3rd Reading SB170",29,8,2,0,39
1398292,1011779,2021-02-22,Senate,"Senate 3rd Reading SB171",29,8,2,0,39
1398293,1011753,2021-02-22,Senate,"Senate 3rd Reading SB172",29,8,2,0,39
1398294,1011762,2021-02-22,Senate,"Senate 3rd Reading SB173",29,8,2,0,39
1398295,1011835,2021-02-22,Senate,"Senate 3rd Reading SB174",29,8,2,0,39
1398296,1011826,2021-02-22,Senate,"Senate 3rd Reading SB175",29,8,2,0,39
1398297,1011772,2021-02-22,Senate,"Senate 3rd Reading SB176",29,8,2,0,39
1398298,1011758,2021-02-22,Senate,"Senate 3rd Reading SB177",29,8,2,0,39
1398299,1011757,2021-02-22,Senate,"Senate 3rd Reading SB178",29,8,2,0,39
1398300,1011726,2021-02-22,Senate,"Senate 3rd Reading SB179",29,8,2,0,39
1398301,1011774,2021-02-22,Senate,"Senate 3rd Reading SB180",29,8,2,0,39
1398302,1011782,2021-02-22,Senate,"Senate 3rd Reading SB181",29,8,2,0,39
1398303,1011788,2021-02-22,Senate,"Senate 3rd Reading SB182",29,8,2,0,39
1398304,1011793,2021-02-22,Senate,"Senate 3rd Reading SB183",29,8,2,0,39
1398305,1011796,2021-02-22,Senate,"Senate 3rd Reading SB184",29,8,2,0,39
1398306,1011769,2021-02-22,Senate,"Senate 3rd Reading SB185",29,8,2,0,39
1398307,1011724,2021-02-22,Senate,"Senate 3rd Reading SB186",29,8,2,0,39
1398308,1011828,2021-02-22,Senate,"Senate 3rd Reading SB187",29,8,2,0,39
1398309,1011823,2021-02-22,Senate,"Senate 3rd Reading SB188",29,8,2,0,39
1398310,1011759,2021-02-22,Senate,"Senate 3rd Reading SB189",29,8,2,0,39
1398311,1011708,2021-02-22,Senate,"Senate 3rd Reading SB190",29,8,2,0,39
1398312,1011784,2021-02-22,Senate,"Senate 3rd Reading SB191",29,8,2,0,39
1398313,1011756,2021-02-22,Senate,"Senate 3rd Reading SB192",29,8,2,0,39
1398314,1011764,2021-02-22,Senate,"Senate 3rd Reading SB193",29,8,2,0,39
1398315,1011732,2021-02-22,Senate,"Senate 3rd Reading SB194",29,8,2,0,39
1398316,1011700,2021-02-22,Senate,"Senate 3rd Reading SB195",29,8,2,0,39
1398317,1011702,2021-02-22,Senate,"Senate 3rd Reading SB196",29,8,2,0,39
1398318,1011765,2021-02-22,Senate,"Senate 3rd Reading SB197",29,8,2,0,39
1398319,1011805,2021-02-22,Senate,"Senate 3rd Reading SB198",29,8,2,0,39
1398320,1011776,2021-02-22,Senate,"Senate 3rd Reading SB199",29,8,2,0,39
1398321,1011780,2021-02-22,Senate,"Senate 3rd Reading SB200",29,8,2,0,39
1398322,1011795,2021-02-22,Senate,"Senate 3rd Reading SB201",29,8,2,0,39
1398323,1011716,2021-02-22,Senate,"Senate 3rd Reading SB202",29,8,2,0,39
1400479,1054681,2021-04-15,Assembly,"Do pass and be re-referred to the Committee on [Local Government]",5,0,3,0,8
1400479,1065244,2021-04-28,Assembly,"Do pass and be re-referred to the Committee on [Appropriations]",7,0,1,0,8
1400482,1035220,2021-03-23,Assembly,"Do pass and be re-referred to the Committee on [Health]",8,3,0,0,11
1400485,1047579,2021-04-07,Assembly,"Do pass and be re-referred to the Committee on [Appropriations]",7,0,1,0,8
1400487,1049866,2021-04-08,Assembly,"Do pass and be re-referred to the Committee on [Appropriations]",12,0,3,0,15
1400488,1046197,2021-04-06,Assembly,"Do pass as amended and be re-referred to the Committee on [Appropriations]",18,0,1,0,19
1400489,1046155,2021-04-06,Assembly,"Do pass and be re-referred to the Committee on [Military and Veterans Affairs] with recommendation: To Consent Calendar",18,0,1,0,19
1400489,1065271,2021-04-28,Assembly,"Do pass and be re-referred to the Committee on [Appropriations] with recommendation: To Consent Calendar",11,0,0,0,11
1400490,1059305,2021-04-21,Assembly,"Do pass and be re-referred to the Committee on [Appropriations] with recommendation: To Consent Calendar",8,0,0,0,8
1400492,984519,2021-01-11,Assembly,"HR 7 MAYES Assembly Third Reading",51,6,23,0,80
1400493,1028396,2021-03-15,Senate,"Do pass as amended, but first amend, and re-refer to the Committee on [Appropriations]",14,0,0,0,14
1400493,1044980,2021-04-05,Senate,"Placed on suspense file",7,0,0,0,7
1400494,1026094,2021-03-10,Senate,"Do pass, but first be re-referred to the Committee on [Appropriations]",4,2,1,0,7
1400494,1033632,2021-03-22,Senate,"Placed on suspense file",7,0,0,0,7
1400495,1023876,2021-03-08,Senate,"Do pass, but first be re-referred to the Committee on [Judiciary]",5,0,0,0,5
1400495,1035223,2021-03-23,Senate,"Do pass as amended, but first amend, and re-refer to the Committee on [Appropriations] with the recommendation: To Consent Calendar",11,0,0,0,11
1400495,1056371,2021-04-19,Senate,"Placed on suspense file",7,0,0,0,7
1400496,1028405,2021-03-15,Senate,"Do pass as amended, but first amend, and re-refer to the Committee on [Appropriations] with the recommendation: To Consent Calendar",7,0,0,0,7
1400496,1044990,2021-04-05,Senate,"Placed on suspense file",7,0,0,0,7
1403935,1065113,2021-04-27,Assembly,"Do pass and be re-referred to the Committee on [Appropriations]",19,0,0,0,19
1403935,1073415,2021-05-05,Assembly,"Do pass",16,0,0,0,16
1403938,1035212,2021-03-22,Assembly,"Do pass and be re-referred to the Committee on [Appropriations] with recommendation: To Consent Calendar",15,0,0,0,15
1403938,1053427,2021-04-14,Assembly,"Do pass. To Consent Calendar",16,0,0,0,16
1403938,1060907,2021-04-22,Assembly,"AB 232 Gallagher Consent Calendar Second Day",77,0,2,0,79
1403939,1048994,2021-04-08,Assembly,"Do pass and be re-referred to the Committee on [Appropriations]",12,0,0,0,12
1403940,1035174,2021-03-23,Assembly,"Do pass and be re-referred to the Committee on [Appropriations] with recommendation: To Consent Calendar",15,0,0,0,15
1403942,1036498,2021-03-24,Assembly,"Be adopted. To third reading",9,0,2,0,11
1403942,1044984,2021-04-05,Assembly,"AJR 4 Cristina Garcia Assembly Third Reading",60,0,18,0,78
1403943,1029563,2021-03-16,Senate,"Do pass, but first be re-referred to the Committee on [Appropriations] with the recommendation: To Consent Calendar",9,0,0,0,9
1403943,1033629,2021-03-22,Senate,"Placed on suspense file",7,0,0,0,7
1403945,1035193,2021-03-23,Senate,"Do pass, but first be re-referred to the Committee on [Appropriations]",9,1,1,0,11
1403945,1044961,2021-04-05,Senate,"Placed on suspense file",7,0,0,0,7
1403946,1072213,2021-05-04,Senate,"Do pass as amended, and be ordered to the Consent Calendar",11,0,0,0,11
1403946,1075254,2021-05-10,Senate,"Consent Calendar SB211",37,0,3,0,40
1403947,1057719,2021-04-20,Senate,"Do pass, but first be re-referred to the Committee on [Appropriations]",1,3,1,0,5
1403948,1038723,2021-03-22,Senate,"Do pass, but first be re-referred to the Committee on [Appropriations]",4,1,0,0,5
1403948,1056322,2021-04-19,Senate,"Placed on suspense file",7,0,0,0,7
1403949,1051991,2021-04-13,Senate,"Do pass, but first be re-referred to the Committee on [Appropriations] with the recommendation: To Consent Calendar",16,0,1,0,17
1403949,1075256,2021-05-10,Senate,"Consent Calendar SB214",37,0,3,0,40
1405776,1054736,2021-04-15,Assembly,"Do pass and be re-referred to the Committee on [Appropriations]",5,0,2,0,7
1405776,1065120,2021-04-28,Assembly,"Do pass",12,4,0,0,16
1405777,1054663,2021-04-15,Assembly,"Do pass and be re-referred to the Committee on [Appropriations]",6,0,1,0,7
1405777,1065080,2021-04-28,Assembly,"Do pass",13,3,0,0,16
1405779,1048902,2021-04-08,Assembly,"Do pass and be re-referred to the Committee on [Appropriations]",22,0,0,0,22
1405779,1065124,2021-04-28,Assembly,"Do pass. To Consent Calendar",16,0,0,0,16
1405779,1074120,2021-05-06,Assembly,"AB 239 Villapudua Consent Calendar Second Day Regular Session",77,0,1,0,78
1405780,1046179,2021-04-06,Assembly,"Do pass and be re-referred to the Committee on [Appropriations] with recommendation: To Consent Calendar",15,0,0,0,15
1405782,1047560,2021-04-07,Assembly,"Do pass as amended, and be re-referred to the Committee on [Appropriations] with recommendation: To Consent Calendar",15,0,0,0,15
1405782,1059282,2021-04-21,Assembly,"Do pass. To Consent Calendar",14,0,2,0,16
1405785,1036536,2021-03-24,Assembly,"Do pass and be re-referred to the Committee on [Appropriations]",11,0,1,0,12
1405785,1053520,2021-04-14,Assembly,"Do pass",12,0,4,0,16
1405786,1035187,2021-03-23,Assembly,"Do pass and be re-referred to the Committee on [Appropriations]",17,0,2,0,19
1405786,1053575,2021-04-14,Assembly,"Do pass. To Consent Calendar",16,0,0,0,16
1405786,1060819,2021-04-22,Assembly,"AB 246 Quirk Consent Calendar Second Day Regular Session",77,0,2,0,79
1405788,1025126,2021-03-09,Senate,"Do pass, but first be re-referred to the Committee on [Appropriations] with the recommendation: To Consent Calendar",4,0,0,0,4
1405788,1033623,2021-03-22,Senate,"Placed on suspense file",7,0,0,0,7
1405789,1023844,2021-03-08,Senate,"Do pass as amended, but first amend, and re-refer to the Committee on [Appropriations]",14,0,0,0,14
1405789,1033648,2021-03-22,Senate,"Placed on suspense file",7,0,0,0,7
1405790,1026109,2021-03-10,Senate,"Do pass, but first be re-referred to the Committee on [Appropriations]",3,3,1,0,7
1405790,1026110,2021-03-10,Senate,"[03-10-2021] hearing: Motion to Reconsider. [Reconsideration Granted.]",7,0,0,0,7
1405790,1053422,2021-03-10,Senate,"[First] hearing set for [04-14-2021]: Failed passage in Committee. Reconsideration granted",7,0,0,0,7
1405790,1065261,2021-04-28,Senate,"Do pass as amended, but first amend, and re-refer to the Committee on [Appropriations]",4,1,2,0,7
1405791,1026095,2021-03-10,Senate,"Do pass, but first be re-referred to the Committee on [Judiciary]",9,0,0,0,9
1405791,1047580,2021-04-06,Senate,"Do pass as amended, but first amend, and re-refer to the Committee on [Appropriations] with the recommendation: To Consent Calendar",11,0,0,0,11
1405791,1060865,2021-04-22,Senate,"Consent Calendar SB218",38,0,2,0,40
1405792,1027180,2021-03-11,Senate,"Do pass, but first be re-referred to the Committee on [Appropriations] with the recommendation: To Consent Calendar",5,0,0,0,5
1405792,1037843,2021-03-25,Senate,"Consent Calendar SB219 McGuire et al. Urgency Clause",38,0,2,0,40
1405794,1030783,2021-03-17,Senate,"Do pass as amended, but first amend, and re-refer to the Committee on [Appropriations]",9,0,2,0,11
1405794,1068257,2021-05-03,Senate,"Placed on suspense file",6,0,1,0,7
1407539,1036477,2021-03-24,Assembly,"Do pass",12,0,0,0,12
1407539,1049019,2021-04-08,Assembly,"AB 251 Choi Assembly Third Reading",74,0,4,0,78
1407540,1049888,2021-04-08,Assembly,"Do pass and be re-referred to the Committee on [Appropriations]",15,0,0,0,15
1407541,1036465,2021-03-23,Assembly,"Do pass",5,2,1,0,8
1407541,1054676,2021-04-15,Assembly,"AB 253 Patterson Assembly Third Reading",50,11,17,0,78
1407542,1053429,2021-04-13,Assembly,"Do pass and be re-referred to the Committee on [Appropriations] with recommendation: To Consent Calendar",8,0,0,0,8
1407543,1072229,2021-05-04,Assembly,"Do pass as amended",8,3,0,0,11
1407544,1036483,2021-03-23,Assembly,"Do pass and be re-referred to the Committee on [Appropriations]",6,2,0,0,8
1407546,1050811,2021-04-12,Senate,"Do pass as amended, but first amend, and re-refer to the Committee on [Environmental Quality]",11,2,1,0,14
1407546,1066777,2021-04-29,Senate,"Do pass as amended, but first amend, and re-refer to the Committee on [Appropriations]",5,2,0,0,7
1407547,1050813,2021-04-12,Senate,"Do pass as amended, but first amend, and re-refer to the Committee on [Environmental Quality]",11,1,2,0,14
1407547,1066800,2021-04-29,Senate,"Do pass as amended, but first amend, and re-refer to the Committee on [Appropriations]",5,2,0,0,7
1407548,1026098,2021-03-10,Senate,"Do pass as amended, but first amend, and re-refer to the Committee on [Appropriations]",7,0,0,0,7
1407548,1044945,2021-04-05,Senate,"Placed on suspense file",7,0,0,0,7
1408675,1060989,2021-04-22,Assembly,"Do pass and be re-referred to the Committee on [Judiciary]",5,2,0,0,7
1408675,1064031,2021-04-27,Assembly,"Do pass as amended and be re-referred to the Committee on [Appropriations]",7,3,1,0,11
1408676,1054643,2021-04-15,Assembly,"Do pass as amended and be re-referred to the Committee on [Judiciary]",8,0,0,0,8
1408676,1064117,2021-04-27,Assembly,"Do pass and be re-referred to the Committee on [Appropriations]",10,0,1,0,11
1408678,1035177,2021-03-23,Assembly,"Do pass and be re-referred to the Committee on [Human Services] with recommendation: To Consent Calendar",11,0,0,0,11
1408678,1059162,2021-04-21,Assembly,"Do pass and be re-referred to the Committee on [Appropriations] with recommendation: To Consent Calendar",8,0,0,0,8
1408678,1073365,2021-05-05,Assembly,"Do pass. To Consent Calendar",16,0,0,0,16
1408678,1077583,2021-05-13,Assembly,"AB 260 Stone Consent Calendar Second Day",75,0,3,0,78
1408680,1036487,2021-03-23,Assembly,"Do pass and be re-referred to the Committee on [Appropriations] with recommendation: To Consent Calendar",8,0,0,0,8
1408681,1036473,2021-03-23,Assembly,"Do pass",8,0,0,0,8
1408681,1066698,2021-04-29,Assembly,"AB 263 Arambula Third Reading Urgency",71,0,7,0,78
1408683,1035191,2021-03-23,Assembly,"Do pass and be re-referred to the Committee on [Appropriations]",15,0,0,0,15
1408684,1053574,2021-04-13,Assembly,"Do pass and be re-referred to the Committee on [Appropriations]",2,4,2,0,8
1408684,1059190,2021-04-20,Assembly,Reconsideration,8,0,0,0,8
1408685,1036420,2021-03-24,Assembly,"Do pass and be re-referred to the Committee on [Appropriations]",8,1,2,0,11
1408685,1053537,2021-04-14,Assembly,"Do pass",13,0,3,0,16
1408685,1066680,2021-04-29,Assembly,"AB 267 Valladares Assembly Third Reading",62,2,14,0,78
1408686,1047545,2021-04-06,Assembly,"Do pass and be re-referred to the Committee on [Privacy and Consumer Protection]",7,0,1,0,8
1408686,1060834,2021-04-22,Assembly,"Do pass and be re-referred to the Committee on [Appropriations]",8,1,2,0,11
1408689,992316,2021-01-28,Assembly,"Be adopted. To Consent Calendar",10,0,2,0,12
1408689,996622,2021-02-04,Assembly,"HR 9 Kiley Consent Calendar Second Day Regular Session",72,0,7,0,79
1408690,1026127,2021-03-10,Senate,"Do pass, but first be re-referred to the Committee on [Appropriations] with the recommendation: To Consent Calendar",11,0,0,0,11
1408690,1037818,2021-03-25,Senate,"Consent Calendar SB226",38,0,2,0,40
1408691,1051911,2021-04-13,Senate,"Do pass, but first be re-referred to the Committee on [Natural Resources and Water]",12,2,3,0,17
1408691,1064003,2021-04-27,Senate,"Do pass, but first be re-referred to the Committee on [Appropriations]",6,2,1,0,9
1408691,1075251,2021-05-10,Senate,"Placed on suspense file",7,0,0,0,7
1408692,1026120,2021-03-10,Senate,"Do pass, but first be re-referred to the Committee on [Human Services] with the recommendation: To Consent Calendar",7,0,0,0,7
1408692,1035180,2021-03-23,Senate,"Do pass, but first be re-referred to the Committee on [Appropriations] with the recommendation: To Consent Calendar",5,0,0,0,5
1408692,1045001,2021-04-05,Senate,"Placed on suspense file",7,0,0,0,7
1411970,1057753,2021-04-20,Assembly,"Do pass and be re-referred to the Committee on [Appropriations]",19,0,0,0,19
1411972,1036439,2021-03-24,Assembly,"Do pass and be re-referred to the Committee on [Appropriations]",8,0,0,0,8
1411972,1053505,2021-04-14,Assembly,"Do pass",16,0,0,0,16
1411972,1056487,2021-04-19,Assembly,"AB 271 Robert Rivas Assembly Third Reading",76,1,2,0,79
1411973,1046129,2021-04-06,Assembly,"Do pass",11,0,0,0,11
1411973,1075286,2021-05-10,Assembly,"AB 272 Kiley Assembly Third Reading",72,0,6,0,78
1411974,1065147,2021-04-27,Assembly,"Do pass and be re-referred to the Committee on [Appropriations]",8,0,11,0,19
1411976,1036466,2021-03-24,Assembly,"Do pass",10,1,1,0,12
1411976,1056488,2021-04-19,Assembly,"AB 275 Medina Assembly Third Reading",65,2,12,0,79
1411978,1035196,2021-03-23,Assembly,"Do pass as amended, and be re-referred to the Committee on [Appropriations] with recommendation: To Consent Calendar",11,0,0,0,11
1411978,1053468,2021-04-14,Assembly,"Do pass",16,0,0,0,16
1411978,1060880,2021-04-22,Assembly,"AB 277 Valladares Assembly Third Reading",77,0,2,0,79
1411979,1035162,2021-03-23,Assembly,"Do pass and be re-referred to the Committee on [Appropriations] with recommendation: To Consent Calendar",15,0,0,0,15
1411980,992321,2021-01-28,Assembly,"Be adopted. To Consent Calendar",10,0,2,0,12
1411980,996615,2021-02-04,Assembly,"HR 11 Bauer-Kahan Consent Calendar Second Day Regular Session",72,0,7,0,79
1411981,1053453,2021-04-14,Senate,"Do pass as amended, but first amend, and re-refer to the Committee on [Education]",11,0,0,0,11
1411981,1065228,2021-04-28,Senate,"Do pass as amended, but first amend, and re-refer to the Committee on [Appropriations] with the recommendation: To Consent Calendar",7,0,0,0,7
1411981,1075391,2021-05-10,Senate,"Placed on suspense file",7,0,0,0,7
1411982,1028394,2021-03-15,Senate,"Do pass, but first be re-referred to the Committee on [Appropriations]",7,0,0,0,7
1411983,1064044,2021-04-27,Senate,"Do pass, but first be re-referred to the Committee on [Appropriations]",17,0,0,0,17
1411984,1064006,2021-04-26,Senate,"Do pass, but first be re-referred to the Committee on [Appropriations]",5,0,0,0,5
1411984,1075307,2021-05-10,Senate,"Placed on suspense file",7,0,0,0,7
1411985,1047589,2021-04-06,Senate,"Do pass and be ordered to the Consent Calendar",11,0,0,0,11
1411985,1060812,2021-04-22,Senate,"Consent Calendar SB233 Umberg",38,0,2,0,40
1411986,1025100,2021-03-09,Senate,"Do pass, but first be re-referred to the Committee on [Housing]",4,0,0,0,4
1411986,1054594,2021-04-15,Senate,"Do pass, but first be re-referred to the Committee on [Appropriations] with the recommendation: To Consent Calendar",9,0,0,0,9
1411986,1068187,2021-05-03,Senate,"Placed on suspense file",6,0,1,0,7
1411987,1026122,2021-03-10,Senate,"Do pass, but first be re-referred to the Committee on [Agriculture]",11,0,0,0,11
1411987,1054745,2021-04-15,Senate,"Do pass, but first be re-referred to the Committee on [Appropriations]",5,0,0,0,5
1411987,1075285,2021-05-10,Senate,"Placed on suspense file",7,0,0,0,7
1417849,1052021,2021-04-13,Assembly,"Do pass as amended and be re-referred to the Committee on [Appropriations]",11,2,2,0,15
1417849,1065137,2021-04-28,Assembly,"Do pass",12,4,0,0,16
1417849,1077525,2021-05-13,Assembly,"AB 279 Muratsuchi Third Reading Urgency",58,1,19,0,78
1417852,1047479,2021-04-06,Assembly,"Do pass as amended",5,3,0,0,8
1417853,1054693,2021-04-15,Assembly,"Do pass and be re-referred to the Committee on [Appropriations] with recommendation: To Consent Calendar",12,0,0,0,12
1417853,1065082,2021-04-28,Assembly,"Do pass. To Consent Calendar",16,0,0,0,16
1417853,1074126,2021-05-06,Assembly,"AB 283 Chen Consent Calendar Second Day Regular Session",77,0,1,0,78
1417854,1036533,2021-03-24,Assembly,"Do pass and be re-referred to the Committee on [Appropriations]",8,1,2,0,11
1417855,1036422,2021-03-24,Assembly,"Do pass and be re-referred to the Committee on [Appropriations] with recommendation: To Consent Calendar",7,0,0,0,7
1417856,1060971,2021-04-22,Assembly,"Do pass as amended",9,1,1,0,11
1417856,1077568,2021-05-13,Assembly,"AB 286 Lorena Gonzalez Assembly Third Reading",56,8,14,0,78
1417857,1035167,2021-03-23,Assembly,"Do pass as amended, and be re-referred to the Committee on [Business and Professions] with recommendation: To Consent Calendar",11,0,0,0,11
1417857,1057640,2021-04-20,Assembly,"Do pass and be re-referred to the Committee on [Appropriations] with recommendation: To Consent Calendar",19,0,0,0,19
1417858,1036489,2021-03-24,Assembly,"Do pass and be re-referred to the Committee on [Appropriations]",12,0,0,0,12
1417859,1054600,2021-04-15,Assembly,"Do pass and be re-referred to the Committee on [Higher Education]",7,0,0,0,7
1417859,1060906,2021-04-22,Assembly,"Do pass and be re-referred to the Committee on [Appropriations]",11,1,0,0,12
1417859,1073363,2021-05-05,Assembly,"Do pass",14,0,2,0,16
1417859,1077601,2021-05-13,Assembly,"AB 289 Calderon Assembly Third Reading",70,0,8,0,78
1417862,1036428,2021-03-23,Assembly,"Do pass and be re-referred to the Committee on [Appropriations]",6,2,0,0,8
1417863,1035140,2021-03-23,Assembly,"Do pass and be re-referred to the Committee on [Business and Professions] with recommendation: To Consent Calendar",11,0,0,0,11
1417863,1051964,2021-04-13,Assembly,"Do pass and be re-referred to the Committee on [Appropriations]",17,0,2,0,19
1417866,992308,2021-01-28,Assembly,"Be adopted. To Consent Calendar",10,0,2,0,12
1417866,996628,2021-02-04,Assembly,"ACR 11 Flora Consent Calendar Second Day",72,0,7,0,79
1417866,1018557,2021-03-01,Senate,"Assembly 3rd Reading ACR11 Flora et al",36,0,3,0,39
1417869,992291,2021-01-28,Assembly,"Be adopted. To Consent Calendar",10,0,2,0,12
1417869,996621,2021-02-04,Assembly,"ACR 14 Stone Consent Calendar Second Day Regular Session",72,0,7,0,79
1417869,1018538,2021-03-01,Senate,"Assembly 3rd Reading ACR14",36,0,3,0,39
1417871,1026138,2021-03-10,Senate,"Do pass, but first be re-referred to the Committee on [Appropriations]",7,0,0,0,7
1417871,1033640,2021-03-22,Senate,"Placed on suspense file",7,0,0,0,7
1417872,1059297,2021-04-20,Senate,"Do pass, but first be re-referred to the Committee on [Appropriations]",2,9,0,0,11
1417872,1059298,2021-04-20,Senate,"[First] hearing set for [04-21-2021]: Failed passage in Committee. Reconsideration granted",11,0,0,0,11
1417873,1026086,2021-03-10,Senate,"Do pass, but first be re-referred to the Committee on [Appropriations] with the recommendation: To Consent Calendar",9,0,0,0,9
1417873,1037839,2021-03-25,Senate,"Consent Calendar SB239 B. & F.I",38,0,2,0,40
1417874,1037863,2021-03-25,Senate,"Do pass, but first be re-referred to the Committee on [Appropriations]",5,0,0,0,5
1417874,1056433,2021-04-19,Senate,"Placed on suspense file",7,0,0,0,7
1417875,1044937,2021-04-05,Senate,"Do pass as amended, but first amend, and re-refer to the Committee on [Judiciary]",13,0,1,0,14
1417875,1059252,2021-04-20,Senate,"Do pass as amended, but first amend, and re-refer to the Committee on [Appropriations]",9,0,2,0,11
1417875,1075293,2021-05-10,Senate,"Placed on suspense file",7,0,0,0,7
1417876,1026124,2021-03-10,Senate,"Do pass as amended, but first amend, and re-refer to the Committee on [Appropriations]",8,2,1,0,11
1417876,1056418,2021-04-19,Senate,"Placed on suspense file",7,0,0,0,7
1417877,1029547,2021-03-16,Senate,"Do pass, but first be re-referred to the Committee on [Appropriations] with the recommendation: To Consent Calendar",5,0,0,0,5
1417877,1045008,2021-04-05,Senate,"Placed on suspense file",7,0,0,0,7
1417878,1028406,2021-03-15,Senate,"Do pass, but first be re-referred to the Committee on [Natural Resources and Water] with the recommendation: To Consent Calendar",7,0,0,0,7
1417878,1064015,2021-04-27,Senate,"Do pass, but first be re-referred to the Committee on [Appropriations] with the recommendation: To Consent Calendar",9,0,0,0,9
1417878,1075314,2021-05-10,Senate,"Placed on suspense file",7,0,0,0,7
1419942,1047577,2021-04-07,Senate,"Do pass as amended, but first amend, and re-refer to the Committee on [Appropriations]",8,2,1,0,11
1419942,1068274,2021-05-03,Senate,"Placed on suspense file",6,0,1,0,7
1419943,1026108,2021-03-10,Senate,"Do pass as amended, but first amend, and re-refer to the Committee on [Human Services]",7,0,0,0,7
1419943,1046153,2021-04-06,Senate,"Do pass, but first be re-referred to the Committee on [Appropriations]",5,0,0,0,5
1419943,1068160,2021-05-03,Senate,"Placed on suspense file",6,0,1,0,7
1419944,1026102,2021-03-10,Senate,"Do pass, but first be re-referred to the Committee on [Appropriations]",11,0,0,0,11
1419944,1068287,2021-05-03,Senate,"Placed on suspense file",6,0,1,0,7
1419945,1029578,2021-03-16,Senate,"Do pass as amended, but first amend, and re-refer to the Committee on [Appropriations]",5,0,0,0,5
1419945,1044957,2021-04-05,Senate,"Placed on suspense file",7,0,0,0,7
1422140,1046107,2021-04-05,Assembly,"Do pass and be re-referred to the Committee on [Appropriations]",10,0,1,0,11
1422140,1059264,2021-04-21,Assembly,"Do pass. To Consent Calendar",14,0,2,0,16
1422140,1066742,2021-04-29,Assembly,"AB 296 Gipson Consent Calendar Second Day Regular Session",77,0,1,0,78
1422142,1046170,2021-04-06,Assembly,"Do pass and be re-referred to the Committee on [Appropriations] with recommendation: To Consent Calendar",18,0,1,0,19
1422142,1059194,2021-04-21,Assembly,"Do pass. To Consent Calendar",14,0,2,0,16
1422142,1066716,2021-04-29,Assembly,"AB 298 Irwin Consent Calendar Second Day Regular Session",77,0,1,0,78
1422146,1036448,2021-03-24,Assembly,"Do pass. To Consent Calendar",8,0,0,0,8
1422146,1049013,2021-04-08,Assembly,"AB 302 Ward Consent Calendar Second Day Regular Session",74,0,4,0,78
1422147,1049873,2021-04-08,Assembly,"Do pass and be re-referred to the Committee on [Natural Resources]",10,0,5,0,15
1422148,1047603,2021-04-07,Assembly,"Do pass and be re-referred to the Committee on [Appropriations]",9,0,0,0,9
1422148,1053519,2021-04-14,Assembly,"Do pass. To Consent Calendar",16,0,0,0,16
1422148,1060972,2021-04-22,Assembly,"AB 304 Quirk Consent Calendar Second Day Regular Session",77,0,2,0,79
1422149,1065196,2021-04-28,Assembly,"Do pass and be re-referred to the Committee on [Appropriations]",11,0,0,0,11
1422150,1036457,2021-03-24,Assembly,"Do pass as amended, and be re-referred to the Committee on [Appropriations] with recommendation: To Consent Calendar",7,0,0,0,7
1422150,1059266,2021-04-21,Assembly,"Do pass. To Consent Calendar",14,0,2,0,16
1422150,1066756,2021-04-29,Assembly,"AB 306 O'Donnell Consent Calendar Second Day Regular Session",77,0,1,0,78
1422152,1036446,2021-03-23,Assembly,"Do pass as amended and be re-referred to the Committee on [Appropriations]",7,0,1,0,8
1422153,1065286,2021-04-28,Assembly,"Do pass and be re-referred to the Committee on [Appropriations]",7,0,0,0,7
1422153,1076928,2021-05-12,Assembly,"Do pass. To Consent Calendar",16,0,0,0,16
1422155,1047562,2021-04-06,Assembly,"Do pass and be re-referred to the Committee on [Appropriations]",5,2,1,0,8
1422156,1036427,2021-03-24,Assembly,"Do pass and be re-referred to the Committee on [Appropriations]",6,0,1,0,7
1422157,1054640,2021-04-15,Assembly,"Do pass and be re-referred to the Committee on [Appropriations] with recommendation: To Consent Calendar",7,0,0,0,7
1422159,1049891,2021-04-08,Assembly,"Do pass and be re-referred to the Committee on [Judiciary] with recommendation: To Consent Calendar",15,0,0,0,15
1422159,1057645,2021-04-20,Assembly,"Do pass as amended, and be re-referred to the Committee on [Appropriations] with recommendation: To Consent Calendar",10,0,1,0,11
1422160,1054591,2021-04-15,Assembly,"Do pass and be re-referred to the Committee on [Appropriations]",7,0,0,0,7
1422161,1005316,2021-02-12,Assembly,"Be adopted. To Consent Calendar",11,0,1,0,12
1422161,1009528,2021-02-18,Assembly,"ACR 15 Luz Rivas Consent Calendar Second Day",68,0,11,0,79
1422161,1037803,2021-03-25,Senate,"Special Consent ACR15",38,0,2,0,40
1422162,1009545,2021-02-18,Assembly,"Be adopted. To third reading",10,0,2,0,12
1422162,1037855,2021-03-25,Senate,"Special Consent ACR16",38,0,2,0,40
1422163,992292,2021-01-28,Assembly,"Be adopted. To third reading",9,0,3,0,12
1422165,992313,2021-01-28,Assembly,"Be adopted. To third reading",10,0,2,0,12
1422166,1059164,2021-04-20,Senate,"Do pass, but first be re-referred to the Committee on [Education]",2,9,0,0,11
1422166,1059165,2021-04-20,Senate,"[First] hearing set for [04-21-2021]: Failed passage in Committee. Reconsideration granted",11,0,0,0,11
1422167,1030777,2021-03-17,Senate,"Do pass, but first be re-referred to the Committee on [Appropriations]",9,1,1,0,11
1422167,1056382,2021-04-19,Senate,"Placed on suspense file",7,0,0,0,7
1422169,1047583,2021-04-06,Senate,"Do pass as amended, but first amend, and re-refer to the Committee on [Appropriations]",7,1,3,0,11
1422169,1056386,2021-04-19,Senate,"Placed on suspense file",7,0,0,0,7
1422171,1030790,2021-03-17,Senate,"Do pass and be ordered to the Consent Calendar",7,0,0,0,7
1422171,1037812,2021-03-25,Senate,"Consent Calendar SB254 Borgeas",38,0,2,0,40
1422172,1051992,2021-04-13,Senate,"Be adopted, but first be re-referred to the Committee on [Appropriations] with recommendation: To Consent Calendar",15,0,2,0,17
1422172,1075250,2021-05-10,Senate,"Consent Calendar SCR7",37,0,3,0,40
1422173,1005296,2021-02-12,Senate,"Senate 3rd Reading SR5 Melendez",32,0,7,0,39
1424570,1047465,2021-04-07,Assembly,"Do pass and be re-referred to the Committee on [Appropriations] with recommendation: To Consent Calendar",8,0,0,0,8
1424570,1059171,2021-04-21,Assembly,"Do pass. To Consent Calendar",14,0,2,0,16
1424570,1066802,2021-04-29,Assembly,"AB 317 Patterson Consent Calendar Second Day Regular Session",77,0,1,0,78
1424571,1059312,2021-04-21,Assembly,"Do pass and be re-referred to the Committee on [Appropriations]",9,0,0,0,9
1424572,1054686,2021-04-15,Assembly,"Do pass and be re-referred to the Committee on [Appropriations] with recommendation: To Consent Calendar",7,0,0,0,7
1424572,1065174,2021-04-28,Assembly,"Do pass. To Consent Calendar",16,0,0,0,16
1424572,1074160,2021-05-06,Assembly,"AB 319 Valladares Consent Calendar Second Day Regular Session",77,0,1,0,78
1424573,1036492,2021-03-24,Assembly,"Do pass and be re-referred to the Committee on [Higher Education] with recommendation: To Consent Calendar",7,0,0,0,7
1424573,1060848,2021-04-22,Assembly,"Do pass as amended and be re-referred to the Committee on [Appropriations]",12,0,0,0,12
1424573,1076951,2021-05-12,Assembly,"Do pass. To Consent Calendar",16,0,0,0,16
1424575,1047430,2021-04-07,Assembly,"Do pass as amended and be re-referred to the Committee on [Natural Resources]",13,0,2,0,15
1424575,1065110,2021-04-28,Assembly,"Do pass and be re-referred to the Committee on [Appropriations]",10,0,1,0,11
1424575,1076925,2021-05-12,Assembly,"Do pass. To Consent Calendar",16,0,0,0,16
1424576,1064106,2021-04-27,Assembly,"Do pass and be re-referred to the Committee on [Appropriations]",11,1,3,0,15
1424576,1073366,2021-05-05,Assembly,"Do pass",13,3,0,0,16
1424578,1065296,2021-04-28,Assembly,"Do pass and be re-referred to the Committee on [Appropriations] with recommendation: To Consent Calendar",11,0,0,0,11
1424579,1035158,2021-03-23,Assembly,"Do pass and be re-referred to the Committee on [Appropriations]",13,1,1,0,15
1424579,1053479,2021-04-14,Assembly,"Do pass",12,4,0,0,16
1424579,1075266,2021-05-10,Assembly,"AB 326 Luz Rivas Assembly Third Reading",56,13,9,0,78
1424581,1029580,2021-03-15,Assembly,"Do pass as amended and be re-referred to the Committee on [Appropriations]",6,2,0,0,8
1424582,1059228,2021-04-21,Senate,"Do pass as amended, but first amend, and re-refer to the Committee on [Appropriations]",11,0,0,0,11
1424583,1065225,2021-04-28,Senate,"Do pass, but first be re-referred to the Committee on [Appropriations]",11,0,0,0,11
1424584,1074138,2021-05-06,Senate,"Do pass, but first be re-referred to the Committee on [Appropriations]",5,0,0,0,5
1424585,1025108,2021-03-09,Senate,"Do pass, but first be re-referred to the Committee on [Appropriations]",3,0,1,0,4
1424585,1074119,2021-05-06,Senate,"Senate 3rd Reading SB258 Laird et al",36,0,4,0,40
1424587,1050840,2021-04-12,Senate,"Do pass as amended, but first amend, and re-refer to the Committee on [Judiciary]",4,2,1,0,7
1424587,1065206,2021-04-27,Senate,"Do pass, but first be re-referred to the Committee on [Appropriations]",8,2,1,0,11
1426671,1036507,2021-03-23,Assembly,"Do pass and be re-referred to the Committee on [Appropriations]",5,2,1,0,8
1426673,1036436,2021-03-23,Assembly,"Do pass and be re-referred to the Committee on [Appropriations] with recommendation: To Consent Calendar",8,0,0,0,8
1426674,1047548,2021-04-07,Assembly,"Do pass and be re-referred to the Committee on [Appropriations] with recommendation: To Consent Calendar",9,0,0,0,9
1426674,1053507,2021-04-14,Assembly,"Do pass. To Consent Calendar",16,0,0,0,16
1426675,1047536,2021-04-06,Assembly,"Do pass",6,2,0,0,8
1426676,1066704,2021-04-29,Assembly,"Do pass and be re-referred to the Committee on [Appropriations]",13,0,0,0,13
1426676,1076980,2021-05-12,Assembly,"Do pass. To Consent Calendar",16,0,0,0,16
1426677,1048878,2021-04-08,Assembly,"Do pass and be re-referred to the Committee on [Appropriations] with recommendation: To Consent Calendar",11,0,0,0,11
1426677,1059170,2021-04-21,Assembly,"Do pass. To Consent Calendar",14,0,2,0,16
1426677,1068181,2021-05-03,Assembly,"AB 335 Boerner Horvath Assembly Third Reading",74,1,3,0,78
1426678,1036494,2021-03-24,Assembly,"Do pass. To Consent Calendar",8,0,0,0,8
1426678,1049030,2021-04-08,Assembly,"AB 336 Villapudua Consent Calendar Second Day Regular Session",74,0,4,0,78
1426679,992312,2021-01-28,Assembly,"Be adopted. To third reading",10,0,2,0,12
1426680,1028424,2021-03-15,Senate,"Do pass, but first be re-referred to the Committee on [Transportation]",5,2,0,0,7
1426681,1035144,2021-03-23,Senate,"Do pass, but first be re-referred to the Committee on [Appropriations]",4,1,0,0,5
1426681,1044941,2021-04-05,Senate,"Placed on suspense file",7,0,0,0,7
1426682,1023857,2021-03-08,Senate,"Do pass, but first be re-referred to the Committee on [Appropriations]",12,1,1,0,14
1426682,1062755,2021-04-26,Senate,"Senate 3rd Reading SB263 Rubio et al",38,0,2,0,40
1426683,1029591,2021-03-16,Senate,"Do pass, but first be re-referred to the Committee on [Rules]",4,1,0,0,5
1426683,1068186,2021-05-03,Senate,"Placed on suspense file",6,0,1,0,7
1426685,1005300,2021-02-12,Senate,"Senate 3rd Reading SCR8 Pan",32,0,7,0,39
1426685,1016268,2021-02-25,Assembly,"Be adopted. To Consent Calendar",11,0,1,0,12
1426685,1022337,2021-03-04,Assembly,"SCR 8 Pan Consent Calendar Second Day Regular Session",72,0,7,0,79
1429090,1036430,2021-03-24,Assembly,"Do pass",12,0,0,0,12
1429090,1053447,2021-04-12,Assembly,"AB 337 Medina Assembly Third Reading",73,0,5,0,78
1429091,1066723,2021-04-29,Assembly,"Do pass and be re-referred to the Committee on [Appropriations]",9,0,3,0,12
1429091,1076949,2021-05-12,Assembly,"Do pass",12,0,4,0,16
1429092,1065254,2021-04-28,Assembly,"Do pass as amended and be re-referred to the Committee on [Appropriations]",7,0,1,0,8
1429093,1036478,2021-03-24,Assembly,"Do pass and be re-referred to the Committee on [Appropriations]",12,0,0,0,12
1429094,1036515,2021-03-23,Assembly,"Do pass as amended. To Consent Calendar",8,0,0,0,8
1429094,1048918,2021-04-08,Assembly,"AB 341 Boerner Horvath Consent Calendar Second Day Regular Session",74,0,4,0,78
1429095,1035183,2021-03-23,Assembly,"Do pass as amended and be re-referred to the Committee on [Appropriations]",14,0,1,0,15
1429096,1053542,2021-04-14,Assembly,"Do pass and be re-referred to the Committee on [Judiciary] with recommendation: To Consent Calendar",7,0,0,0,7
1429096,1057634,2021-04-20,Assembly,"Do pass as amended, and be re-referred to the Committee on [Appropriations] with recommendation: To Consent Calendar",10,0,1,0,11
1429098,1029588,2021-03-15,Assembly,"Do pass and be re-referred to the Committee on [Local Government] with recommendation: To Consent Calendar",8,0,0,0,8
1429098,1036462,2021-03-24,Assembly,"Do pass and be re-referred to the Committee on [Appropriations]",7,1,0,0,8
1429100,1046181,2021-04-06,Assembly,"Do pass as amended and be re-referred to the Committee on [Appropriations]",13,1,1,0,15
1429102,1064058,2021-04-26,Assembly,"Do pass and be re-referred to the Committee on [Appropriations] with recommendation: To Consent Calendar",15,0,0,0,15
1429103,1054644,2021-04-15,Assembly,"Do pass and be re-referred to the Committee on [Water, Parks, and Wildlife]",11,0,0,0,11
1429103,1064064,2021-04-26,Assembly,"Do pass and be re-referred to the Committee on [Appropriations]",15,0,0,0,15
1429104,1060991,2021-04-22,Assembly,"Do pass. To Consent Calendar",21,0,1,0,22
1429104,1066731,2021-04-29,Assembly,"AB 351 Cristina Garcia Consent Calendar Second Day Regular Session",77,0,1,0,78
1429107,1047557,2021-04-07,Assembly,"Do pass and be re-referred to the Committee on [Natural Resources] with recommendation: To Consent Calendar",15,0,0,0,15
1429107,1065180,2021-04-28,Assembly,"Do pass and be re-referred to the Committee on [Appropriations]",11,0,0,0,11
1429109,1029571,2021-03-16,Senate,"Do pass as amended, but first amend, and re-refer to the Committee on [Appropriations]",9,0,0,0,9
1429109,1045005,2021-04-05,Senate,"Placed on suspense file",7,0,0,0,7
1429110,1027189,2021-03-11,Senate,"Do pass, but first be re-referred to the Committee on [Appropriations]",5,0,0,0,5
1429110,1048959,2021-04-08,Senate,"Senate 3rd Reading SB267 Hertzberg",34,2,4,0,40
1429111,1037859,2021-03-25,Senate,"Do pass as amended, but first amend, and re-refer to the Committee on [Appropriations]",5,0,0,0,5
1429111,1056380,2021-04-19,Senate,"Placed on suspense file",7,0,0,0,7
1429112,1026134,2021-03-10,Senate,"Do pass, but first be re-referred to the Committee on [Appropriations]",9,0,0,0,9
1429112,1045013,2021-04-05,Senate,"Senate 3rd Reading SB269 Portantino",38,0,2,0,40
1429113,1046168,2021-04-05,Senate,"Do pass, but first be re-referred to the Committee on [Judiciary]",4,0,1,0,5
1429113,1053551,2021-04-13,Senate,"Do pass as amended, but first amend, and re-refer to the Committee on [Appropriations]",8,2,1,0,11
1429113,1068230,2021-05-03,Senate,"Placed on suspense file",6,0,1,0,7
1429114,1029575,2021-03-16,Senate,"Do pass, but first be re-referred to the Committee on [Governance and Finance]",4,1,0,0,5
1429115,1025115,2021-03-09,Senate,"Be adopted. Ordered to third reading",9,1,1,0,11
1429115,1056346,2021-04-19,Senate,"Senate 3rd Reading SR6 Skinner",29,8,3,0,40
1430809,1051985,2021-04-13,Senate,"Do pass, but first be re-referred to the Committee on [Judiciary] with the recommendation: To Consent Calendar",8,0,1,0,9
1430809,1059231,2021-04-20,Senate,"Do pass and be ordered to the Consent Calendar",11,0,0,0,11
1430809,1066798,2021-04-29,Senate,"Consent Calendar SB272",36,0,4,0,40
1430810,1027169,2021-03-11,Senate,"Do pass, but first be re-referred to the Committee on [Environmental Quality] with the recommendation: To Consent Calendar",5,0,0,0,5
1430810,1050795,2021-04-12,Senate,"Do pass, but first be re-referred to the Committee on [Appropriations] with the recommendation: To Consent Calendar",7,0,0,0,7
1430810,1060898,2021-04-22,Senate,"Consent Calendar SB273",38,0,2,0,40
1430811,1037845,2021-03-25,Senate,"Do pass as amended, but first amend, and re-refer to the Committee on [Appropriations]",5,0,0,0,5
1430811,1060895,2021-04-22,Senate,"Consent Calendar SB274",38,0,2,0,40
1430813,1054752,2021-04-15,Senate,"Do pass, but first be re-referred to the Committee on [Appropriations]",5,0,0,0,5
1430813,1068276,2021-05-03,Senate,"Placed on suspense file",6,0,1,0,7
1430814,1057755,2021-04-20,Senate,"Do pass, but first be re-referred to the Committee on [Judiciary]",14,0,1,0,15
1430814,1068208,2021-05-03,Senate,"Placed on suspense file",6,0,1,0,7
1430815,1023827,2021-03-08,Senate,"Do pass, but first be re-referred to the Committee on [Judiciary]",5,0,0,0,5
1430815,1047552,2021-04-06,Senate,"Do pass, but first be re-referred to the Committee on [Appropriations]",10,1,0,0,11
1430815,1056321,2021-04-19,Senate,"Placed on suspense file",7,0,0,0,7
1430816,1065168,2021-04-28,Senate,"Do pass, but first be re-referred to the Committee on [Appropriations]",11,0,0,0,11
1433149,1046146,2021-04-06,Assembly,"Do pass and be re-referred to the Committee on [Business and Professions]",15,0,0,0,15
1433149,1065293,2021-04-27,Assembly,"Do pass and be re-referred to the Committee on [Appropriations] with recommendation: To Consent Calendar",19,0,0,0,19
1433151,1072245,2021-05-04,Assembly,"Do pass as amended",11,0,0,0,11
1433152,1046184,2021-04-06,Assembly,"Do pass and be re-referred to the Committee on [Appropriations] with recommendation: To Consent Calendar",18,0,1,0,19
1433152,1053440,2021-04-14,Assembly,"Do pass. To Consent Calendar",16,0,0,0,16
1433152,1060885,2021-04-22,Assembly,"AB 359 Cooper Consent Calendar Second Day Regular Session",77,0,2,0,79
1433154,1073384,2021-05-05,Assembly,"Do pass as amended",7,0,1,0,8
1433155,1067607,2021-04-29,Assembly,"Do pass as amended and be re-referred to the Committee on [Appropriations]",6,2,0,0,8
1433156,1064133,2021-04-26,Assembly,"Do pass and be re-referred to the Committee on [Appropriations]",12,0,3,0,15
1433157,1049020,2021-04-08,Assembly,"Do pass and be re-referred to the Committee on [Judiciary]",5,2,0,0,7
1433157,1057747,2021-04-20,Assembly,"Do pass and be re-referred to the Committee on [Appropriations]",8,2,1,0,11
1433159,1047550,2021-04-07,Assembly,"Do pass and be re-referred to the Committee on [Appropriations] with recommendation: To Consent Calendar",8,0,0,0,8
1433160,1036433,2021-03-24,Assembly,"Do pass as amended and be re-referred to the Committee on [Higher Education]",7,0,0,0,7
1433160,1060950,2021-04-22,Assembly,"Do pass as amended and be re-referred to the Committee on [Appropriations]",11,0,1,0,12
1433161,1051975,2021-04-13,Assembly,"Do pass as amended and be re-referred to the Committee on [Appropriations]",15,0,0,0,15
1433162,1057700,2021-04-20,Assembly,"Do pass as amended and be re-referred to the Committee on [Appropriations]",14,0,1,0,15
1433163,1051879,2021-04-13,Assembly,"Do pass as amended and be re-referred to the Committee on [Appropriations]",15,0,0,0,15
1433164,1048979,2021-04-08,Assembly,"Do pass and be re-referred to the Committee on [Judiciary]",9,0,2,0,11
1433164,1051909,2021-04-13,Assembly,"Do pass as amended",11,0,0,0,11
1433164,1077591,2021-05-13,Assembly,"AB 371 Jones-Sawyer Assembly Third Reading",59,3,16,0,78
1433168,1036535,2021-03-24,Assembly,"Do pass and be re-referred to the Committee on [Appropriations]",12,0,0,0,12
1433170,1059258,2021-04-21,Assembly,"Do pass and be re-referred to the Committee on [Appropriations]",5,3,1,0,9
1433171,1035239,2021-03-23,Assembly,"Do pass. To Consent Calendar",11,0,0,0,11
1433171,1062756,2021-04-26,Assembly,"AB 378 Bauer-Kahan Assembly Third Reading",74,0,4,0,78
1433172,1049871,2021-04-08,Assembly,"Do pass and be re-referred to the Committee on [Appropriations]",15,0,0,0,15
1433172,1059295,2021-04-21,Assembly,"Do pass as amended",14,0,2,0,16
1433172,1075253,2021-05-10,Assembly,"AB 379 Gallagher Assembly Third Reading",74,0,4,0,78
1433173,1077559,2021-05-13,Assembly,"Be adopted. To Consent Calendar",10,0,2,0,12
1433174,1005301,2021-02-12,Assembly,"Be adopted. To third reading",11,0,1,0,12
1433174,1018543,2021-03-01,Senate,"Assembly 3rd Reading ACR18",36,0,3,0,39
1433176,1026129,2021-03-10,Senate,"Do pass, but first be re-referred to the Committee on [Judiciary]",11,0,0,0,11
1433176,1035253,2021-03-23,Senate,"Do pass, but first be re-referred to the Committee on [Appropriations] with the recommendation: To Consent Calendar",11,0,0,0,11
1433176,1068245,2021-05-03,Senate,"Do pass",6,0,1,0,7
1433177,1030774,2021-03-17,Senate,"Do pass as amended, but first amend, and re-refer to the Committee on [Appropriations] with the recommendation: To Consent Calendar",10,0,1,0,11
1433177,1075366,2021-05-10,Senate,"Consent Calendar SB281 Dodd Urgency Clause",37,0,3,0,40
1433179,1048992,2021-04-08,Senate,"Do pass",12,0,0,0,12
1433179,1066779,2021-04-29,Senate,"Senate 3rd Reading SB283 Gonzalez",36,0,4,0,40
1433180,1023847,2021-03-08,Senate,"Do pass, but first be re-referred to the Committee on [Appropriations]",4,0,1,0,5
1433180,1033653,2021-03-22,Senate,"Placed on suspense file",7,0,0,0,7
1433181,1023836,2021-03-08,Senate,"Do pass, but first be re-referred to the Committee on [Appropriations]",14,0,0,0,14
1433181,1033643,2021-03-22,Senate,"Placed on suspense file",7,0,0,0,7
1433183,1052018,2021-04-13,Senate,"Do pass, but first be re-referred to the Committee on [Appropriations] with the recommendation: To Consent Calendar",16,0,1,0,17
1433183,1075368,2021-05-10,Senate,"Placed on suspense file",7,0,0,0,7
1433184,1026137,2021-03-10,Senate,"Do pass, but first be re-referred to the Committee on [Judiciary]",9,0,0,0,9
1433184,1029584,2021-03-16,Senate,"Do pass, but first be re-referred to the Committee on [Appropriations] with the recommendation: To Consent Calendar",11,0,0,0,11
1433184,1044954,2021-04-05,Senate,"Do pass",7,0,0,0,7
1433184,1050832,2021-04-12,Senate,"Senate 3rd Reading SB288 Jones et al",39,0,1,0,40
1433185,1050829,2021-04-12,Senate,"Do pass as amended, but first amend, and re-refer to the Committee on [Judiciary]",5,2,0,0,7
1433185,1065264,2021-04-27,Senate,"Do pass, but first be re-referred to the Committee on [Appropriations]",9,2,0,0,11
1433186,1031904,2021-03-18,Senate,"Do pass, but first be re-referred to the Committee on [Governance and Finance]",6,1,2,0,9
1433186,1054605,2021-04-15,Senate,"Do pass, but first be re-referred to the Committee on [Appropriations]",5,0,0,0,5
1433186,1068280,2021-05-03,Senate,"Placed on suspense file",6,0,1,0,7
1433187,1026125,2021-03-10,Senate,"Do pass, but first be re-referred to the Committee on [Appropriations] with the recommendation: To Consent Calendar",7,0,0,0,7
1433187,1033663,2021-03-22,Senate,"Placed on suspense file",7,0,0,0,7
1433188,1031898,2021-03-18,Senate,"Do pass, but first be re-referred to the Committee on [Public Safety] with the recommendation: To Consent Calendar",5,0,0,0,5
1433188,1060956,2021-04-22,Senate,"Consent Calendar SB292",38,0,2,0,40
1433189,1030773,2021-03-17,Senate,"Do pass as amended, but first amend, and re-refer to the Committee on [Appropriations]",11,0,0,0,11
1433189,1068171,2021-05-03,Senate,"Placed on suspense file",6,0,1,0,7
1433190,1005307,2021-02-12,Senate,"Senate 3rd Reading SR7 Ochoa Bogh et al",32,0,7,0,39
1434853,1035147,2021-03-23,Assembly,"Do pass as amended and be re-referred to the Committee on [Judiciary]",15,0,0,0,15
1434853,1053465,2021-04-14,Assembly,"Do pass. To Consent Calendar",16,0,0,0,16
1434853,1060954,2021-04-22,Assembly,"AB 381 Davies Consent Calendar Second Day Regular Session",77,0,2,0,79
1434854,1035204,2021-03-23,Assembly,"Do pass and be re-referred to the Committee on [Appropriations] with recommendation: To Consent Calendar",15,0,0,0,15
1434854,1053459,2021-04-14,Assembly,"Do pass. To Consent Calendar",16,0,0,0,16
1434854,1074192,2021-05-06,Assembly,"AB 382 Kamlager Assembly Third Reading By NAZARIAN",76,0,2,0,78
1434855,1046223,2021-04-06,Assembly,"Do pass and be re-referred to the Committee on [Health]",7,0,0,0,7
1434855,1057624,2021-04-20,Assembly,"Do pass as amended, and be re-referred to the Committee on [Appropriations] with recommendation: To Consent Calendar",15,0,0,0,15
1434856,1051974,2021-04-13,Assembly,"Do pass as amended and be re-referred to the Committee on [Appropriations]",18,0,1,0,19
1434858,1054621,2021-04-15,Assembly,"Do pass and be re-referred to the Committee on [Judiciary]",7,0,0,0,7
1434858,1064135,2021-04-27,Assembly,"Do pass as amended and be re-referred to the Committee on [Appropriations]",6,0,5,0,11
1434858,1076967,2021-05-12,Assembly,"Do pass",10,5,1,0,16
1434860,1036475,2021-03-24,Assembly,"Do pass and be re-referred to the Committee on [Appropriations]",4,2,1,0,7
1434861,1051987,2021-04-13,Assembly,"Do pass",13,0,2,0,15
1434862,1060980,2021-04-22,Assembly,"Do pass",11,0,0,0,11
1434862,1068242,2021-05-03,Assembly,"AB 390 Berman Assembly Third Reading",72,1,5,0,78
1434863,1054734,2021-04-15,Assembly,"Do pass and be re-referred to the Committee on [Appropriations]",11,0,0,0,11
1434864,1051925,2021-04-13,Assembly,"Do pass",18,0,1,0,19
1434864,1074190,2021-05-06,Assembly,"AB 392 Nazarian Assembly Third Reading",73,0,5,0,78
1434865,1059185,2021-04-21,Assembly,"Do pass and be re-referred to the Committee on [Appropriations] with recommendation: To Consent Calendar",8,0,0,0,8
1434866,1056414,2021-04-19,Assembly,"Be adopted. To Consent Calendar",15,0,0,0,15
1434866,1060993,2021-04-22,Assembly,"ACR 19 Gallagher Consent Calendar Second Day Regular Session",77,0,2,0,79
1434867,1016217,2021-02-25,Assembly,"Be adopted. To Consent Calendar",11,0,1,0,12
1434867,1022328,2021-03-04,Assembly,"HR 16 Choi Consent Calendar Second Day Regular Session",72,0,7,0,79
1434869,1023832,2021-03-08,Senate,"Do pass, but first be re-referred to the Committee on [Appropriations]",4,1,0,0,5
1434869,1068277,2021-05-03,Senate,"Senate 3rd Reading SB294 Leyva et al",29,7,4,0,40
1434870,1005302,2021-02-12,Senate,"Senate 3rd Reading SCR9 Rubio et al",32,0,7,0,39
1434870,1016183,2021-02-25,Assembly,"Be adopted. To Consent Calendar",11,0,1,0,12
1434870,1022320,2021-03-04,Assembly,"SCR 9 Rubio Consent Calendar Second Day Regular Session",72,0,7,0,79
1436507,1036503,2021-03-23,Assembly,"Do pass and be re-referred to the Committee on [Appropriations]",6,2,0,0,8
1436508,1049015,2021-04-08,Assembly,"Do pass and be re-referred to the Committee on [Human Services]",11,0,1,0,12
1436508,1059250,2021-04-21,Assembly,"Do pass and be re-referred to the Committee on [Appropriations] with recommendation: To Consent Calendar",8,0,0,0,8
1436509,1054622,2021-04-15,Assembly,"Do pass and be re-referred to the Committee on [Appropriations] with recommendation: To Consent Calendar",13,0,0,0,13
1436510,1035175,2021-03-22,Assembly,"Do pass and be re-referred to the Committee on [Appropriations] with recommendation: To Consent Calendar",15,0,0,0,15
1436510,1065090,2021-04-28,Assembly,"Do pass. To Consent Calendar",16,0,0,0,16
1436510,1074114,2021-05-06,Assembly,"AB 398 Fong Consent Calendar Second Day Regular Session",77,0,1,0,78
1436512,1066722,2021-04-29,Assembly,"Do pass and be re-referred to the Committee on [Appropriations] with recommendation: To Consent Calendar",13,0,0,0,13
1436513,1054667,2021-04-15,Assembly,"Do pass and be re-referred to the Committee on [Appropriations] with recommendation: To Consent Calendar",13,0,0,0,13
1436514,1066824,2021-04-29,Assembly,"Do pass and be re-referred to the Committee on [Appropriations] with recommendation: To Consent Calendar",13,0,0,0,13
1436516,1066776,2021-04-29,Assembly,"Do pass and be re-referred to the Committee on [Appropriations] with recommendation: To Consent Calendar",13,0,0,0,13
1436519,1065129,2021-04-27,Assembly,"Do pass and be re-referred to the Committee on [Appropriations]",19,0,0,0,19
1436519,1073376,2021-05-05,Assembly,"Do pass. To Consent Calendar",16,0,0,0,16
1436519,1077586,2021-05-13,Assembly,"AB 407 Salas Consent Calendar Second Day Regular Session",75,0,3,0,78
1436521,1036449,2021-03-23,Assembly,"Do pass and be re-referred to the Committee on [Judiciary]",7,0,1,0,8
1436521,1046108,2021-04-06,Assembly,"Do pass as amended and be re-referred to the Committee on [Appropriations]",10,0,1,0,11
1436523,1029590,2021-03-15,Assembly,"Do pass and be re-referred to the Committee on [Military and Veterans Affairs]",8,0,0,0,8
1436523,1065186,2021-04-28,Assembly,"Do pass and be re-referred to the Committee on [Appropriations] with recommendation: To Consent Calendar",11,0,0,0,11
1436524,1065251,2021-04-28,Assembly,"Do pass as amended and be re-referred to the Committee on [Appropriations]",7,0,0,0,7
1436525,1029586,2021-03-15,Assembly,"Do pass as amended and be re-referred to the Committee on [Human Services]",8,0,0,0,8
1436525,1047460,2021-04-07,Assembly,"Do pass and be re-referred to the Committee on [Appropriations] with recommendation: To Consent Calendar",8,0,0,0,8
1436526,1054721,2021-04-14,Assembly,"Do pass. To Consent Calendar",8,0,0,0,8
1436526,1060836,2021-04-22,Assembly,"AB 414 Maienschein Consent Calendar Second Day Regular Session",77,0,2,0,79
1436529,1035258,2021-03-23,Senate,"Do pass, but first be re-referred to the Committee on [Appropriations] with the recommendation: To Consent Calendar",5,0,0,0,5
1436529,1044994,2021-04-05,Senate,"Placed on suspense file",7,0,0,0,7
1436530,1023840,2021-03-08,Senate,"Do pass as amended, but first amend, and re-refer to the Committee on [Judiciary]",14,0,0,0,14
1436530,1035264,2021-03-23,Senate,"Do pass as amended, but first amend, and re-refer to the Committee on [Appropriations]",11,0,0,0,11
1436530,1068229,2021-05-03,Senate,"Senate 3rd Reading SB297 Durazo",36,0,4,0,40
1436531,1025093,2021-03-09,Senate,"Do pass as amended, but first amend, and re-refer to the Committee on [Appropriations]",13,0,1,0,14
1436531,1062753,2021-04-26,Senate,"Senate 3rd Reading SB298 Dodd",38,0,2,0,40
1436532,1051970,2021-04-13,Senate,"Do pass, but first be re-referred to the Committee on [Appropriations]",5,0,0,0,5
1436532,1068155,2021-05-03,Senate,"Placed on suspense file",6,0,1,0,7
1436533,1046111,2021-04-06,Senate,"Do pass, but first be re-referred to the Committee on [Appropriations]",4,0,1,0,5
1436533,1056426,2021-04-19,Senate,"Placed on suspense file",7,0,0,0,7
1436535,1025095,2021-03-09,Senate,"Do pass, but first be re-referred to the Committee on [Appropriations] with the recommendation: To Consent Calendar",14,0,0,0,14
1436535,1037801,2021-03-25,Senate,"Consent Calendar SB302 G.O",38,0,2,0,40
1436536,1027173,2021-03-11,Senate,"Do pass, but first be re-referred to the Committee on [Appropriations]",5,0,0,0,5
1436536,1066695,2021-04-29,Senate,"Senate 3rd Reading SB303 Borgeas et al",36,0,4,0,40
1436537,1033627,2021-03-22,Senate,"Do pass as amended, but first amend, and re-refer to the Committee on [Appropriations]",8,0,6,0,14
1436538,1028421,2021-03-15,Senate,"Do pass, but first be re-referred to the Committee on [Appropriations] with the recommendation: To Consent Calendar",5,0,0,0,5
1436538,1033669,2021-03-22,Senate,"Placed on suspense file",7,0,0,0,7
1436539,1007232,2021-02-16,Senate,"Senate 3rd Reading SCR10 Bradford et al",33,0,6,0,39
1436539,1016176,2021-02-25,Assembly,"Be adopted. To Consent Calendar",11,0,1,0,12
1436539,1022325,2021-03-04,Assembly,"SCR 10 Bradford Consent Calendar Second Day Regular Session",72,0,7,0,79
1438433,1065290,2021-04-28,Assembly,"Do pass and be re-referred to the Committee on [Appropriations]",4,3,0,0,7
1438434,1036497,2021-03-24,Assembly,"Do pass and be re-referred to the Committee on [Appropriations]",12,0,0,0,12
1438435,1046128,2021-04-05,Assembly,"Do pass as amended and be re-referred to the Committee on [Utilities and Energy]",7,0,0,0,7
1438436,1036544,2021-03-23,Assembly,"Do pass as amended",8,0,0,0,8
1438436,1053421,2021-04-12,Assembly,"AB 419 Davies Assembly Third Reading",74,0,4,0,78
1438438,1036413,2021-03-24,Assembly,"Do pass and be re-referred to the Committee on [Appropriations]",12,0,0,0,12
1438441,1054646,2021-04-15,Assembly,"Do pass and be re-referred to the Committee on [Judiciary]",9,3,0,0,12
1438441,1057632,2021-04-20,Assembly,"Do pass as amended and be re-referred to the Committee on [Appropriations]",8,2,1,0,11
1438442,1054624,2021-04-15,Assembly,"Do pass and be re-referred to the Committee on [Appropriations] with recommendation: To Consent Calendar",11,0,0,0,11
1438442,1073337,2021-05-05,Assembly,"Do pass. To Consent Calendar",16,0,0,0,16
1438442,1077607,2021-05-13,Assembly,"AB 425 Mathis Consent Calendar Second Day Regular Session",75,0,3,0,78
1438444,1059239,2021-04-21,Assembly,"Do pass as amended and be re-referred to the Committee on [Appropriations]",11,2,2,0,15
1438445,1054652,2021-04-14,Assembly,"Do pass and be re-referred to the Committee on [Elections]",7,1,0,0,8
1438445,1066760,2021-04-29,Assembly,"Do pass",6,0,1,0,7
1438445,1077534,2021-05-13,Assembly,"AB 428 Mayes Assembly Third Reading",48,11,19,0,78
1438446,1035157,2021-03-23,Assembly,"Do pass and be re-referred to the Committee on [Appropriations] with recommendation: To Consent Calendar",11,0,0,0,11
1438446,1053526,2021-04-14,Assembly,"Do pass. To Consent Calendar",16,0,0,0,16
1438446,1060909,2021-04-22,Assembly,"AB 429 Megan Dahle Consent Calendar Second Day Regular Session",77,0,2,0,79
1438447,1054597,2021-04-15,Assembly,"Do pass and be re-referred to the Committee on [Judiciary] with recommendation: To Consent Calendar",12,0,0,0,12
1438447,1057635,2021-04-20,Assembly,"Do pass as amended. To Consent Calendar",10,0,1,0,11
1438447,1066708,2021-04-29,Assembly,"AB 430 Grayson Consent Calendar Second Day",77,0,1,0,78
1438448,1036467,2021-03-24,Assembly,"Do pass and be re-referred to the Committee on [Appropriations] with recommendation: To Consent Calendar",11,0,0,0,11
1438448,1053435,2021-04-14,Assembly,"Do pass. To Consent Calendar",16,0,0,0,16
1438448,1060844,2021-04-22,Assembly,"AB 431 Patterson Consent Calendar Second Day Regular Session",77,0,2,0,79
1438452,1046194,2021-04-06,Assembly,"Do pass and be re-referred to the Committee on [Appropriations] with recommendation: To Consent Calendar",18,0,1,0,19
1438452,1053441,2021-04-14,Assembly,"Do pass. To Consent Calendar",16,0,0,0,16
1438452,1061002,2021-04-22,Assembly,"AB 435 Mullin Consent Calendar Second Day Regular Session",77,0,2,0,79
1438454,1036537,2021-03-24,Assembly,"Do pass and be re-referred to the Committee on [Appropriations] with recommendation: To Consent Calendar",7,0,0,0,7
1438455,1054722,2021-04-15,Assembly,"Do pass and be re-referred to the Committee on [Appropriations]",6,1,0,0,7
1438456,1046211,2021-04-06,Assembly,"Do pass",13,1,1,0,15
1438456,1056489,2021-04-19,Assembly,"AB 439 Bauer-Kahan Assembly Third Reading",65,2,12,0,79
1438457,1047544,2021-04-07,Assembly,"Do pass and be re-referred to the Committee on [Appropriations] with recommendation: To Consent Calendar",9,0,0,0,9
1438457,1053510,2021-04-14,Assembly,"Do pass. To Consent Calendar",16,0,0,0,16
1438457,1060922,2021-04-22,Assembly,"AB 440 Bigelow Consent Calendar Second Day Regular Session",77,0,2,0,79
1438458,1046116,2021-04-06,Assembly,"Do pass as amended and be re-referred to the Committee on [Appropriations]",15,0,0,0,15
1438458,1059161,2021-04-21,Assembly,"Do pass. To Consent Calendar",14,0,2,0,16
1438458,1066681,2021-04-29,Assembly,"AB 441 Mayes Consent Calendar Second Day Regular Session",77,0,1,0,78
1438459,1036426,2021-03-24,Assembly,"Do pass and be re-referred to the Committee on [Water, Parks, and Wildlife] with recommendation: To Consent Calendar",11,0,0,0,11
1438459,1064008,2021-04-26,Assembly,"Do pass and be re-referred to the Committee on [Appropriations] with recommendation: To Consent Calendar",15,0,0,0,15
1438459,1073356,2021-05-05,Assembly,"Do pass as amended. To Consent Calendar",16,0,0,0,16
1438460,1065112,2021-04-27,Assembly,"Do pass and be re-referred to the Committee on [Appropriations] with recommendation: To Consent Calendar",19,0,0,0,19
1438460,1076946,2021-05-12,Assembly,"Do pass",16,0,0,0,16
1438461,1005309,2021-02-12,Assembly,"Be adopted. To third reading",11,0,1,0,12
1438461,1037844,2021-03-25,Senate,"Special Consent ACR20",38,0,2,0,40
1438462,1044969,2021-04-05,Assembly,"Be adopted. To Consent Calendar",14,0,1,0,15
1438462,1048954,2021-04-08,Assembly,"ACR 21 Megan Dahle Consent Calendar Second Day Regular Session",74,0,4,0,78
1438463,1022314,2021-03-04,Assembly,"Be adopted. To Consent Calendar",11,0,1,0,12
1438463,1050773,2021-04-12,Senate,"Assembly 3rd Reading ACR22 Boerner Horvath",39,0,1,0,40
1438465,1060863,2021-04-22,Assembly,"Be adopted. To third reading",12,0,0,0,12
1438466,1047561,2021-04-07,Senate,"Do pass, but first be re-referred to the Committee on [Business, Professions and Economic Development]",9,1,1,0,11
1438466,1056360,2021-04-19,Senate,"Do pass, but first be re-referred to the Committee on [Appropriations]",10,3,1,0,14
1438466,1075344,2021-05-10,Senate,"Placed on suspense file",7,0,0,0,7
1438468,1025099,2021-03-09,Senate,"Do pass, but first be re-referred to the Committee on [Appropriations] with the recommendation: To Consent Calendar",11,0,0,0,11
1438468,1037815,2021-03-25,Senate,"Consent Calendar SB308",38,0,2,0,40
1438469,1026106,2021-03-10,Senate,"Do pass, but first be re-referred to the Committee on [Appropriations]",5,0,2,0,7
1438469,1033686,2021-03-22,Senate,"Placed on suspense file",7,0,0,0,7
1438470,1023852,2021-03-08,Senate,"Do pass, but first be re-referred to the Committee on [Judiciary]",14,0,0,0,14
1438470,1047447,2021-04-06,Senate,"Do pass as amended, but first amend, and re-refer to the Committee on [Appropriations] with the recommendation: To Consent Calendar",11,0,0,0,11
1438470,1056416,2021-04-19,Senate,"Placed on suspense file",7,0,0,0,7
1438471,1026097,2021-03-10,Senate,"Do pass",11,0,0,0,11
1438471,1033687,2021-03-22,Senate,"Senate 3rd Reading SB311 Hueso et al",36,0,4,0,40
1438474,1057751,2021-04-20,Senate,"Do pass, but first be re-referred to the Committee on [Appropriations]",15,0,0,0,15
1438474,1068204,2021-05-03,Senate,"Placed on suspense file",6,0,1,0,7
1438475,1047537,2021-04-06,Senate,"Do pass, but first be re-referred to the Committee on [Appropriations]",10,0,1,0,11
1438475,1056378,2021-04-19,Senate,"Placed on suspense file",7,0,0,0,7
1438476,1026117,2021-03-10,Senate,"Do pass, but first be re-referred to the Committee on [Appropriations] with the recommendation: To Consent Calendar",11,0,0,0,11
1438476,1033679,2021-03-22,Senate,"Placed on suspense file",7,0,0,0,7
1438477,1064032,2021-04-27,Senate,"Do pass as amended, but first amend, and re-refer to the Committee on [Appropriations]",5,0,0,0,5
1438479,1048988,2021-04-08,Senate,"Do pass",5,0,0,0,5
1438479,1068200,2021-05-03,Senate,"Senate 3rd Reading SB319 Melendez",36,0,4,0,40
1438480,1025125,2021-03-09,Senate,"Do pass, but first be re-referred to the Committee on [Judiciary]",4,0,0,0,4
1438480,1035173,2021-03-23,Senate,"Do pass as amended, but first amend, and re-refer to the Committee on [Appropriations] with the recommendation: To Consent Calendar",11,0,0,0,11
1438480,1056421,2021-04-19,Senate,"Placed on suspense file",7,0,0,0,7
1438481,1048989,2021-04-08,Senate,"Senate 3rd Reading SCR11 Rubio et al",38,0,2,0,40
1438482,1052022,2021-04-13,Senate,"Be adopted, but first be re-referred to the Committee on [Appropriations] with recommendation: To Consent Calendar",15,0,2,0,17
1438482,1075288,2021-05-10,Senate,"Consent Calendar SCR12",37,0,3,0,40
1439683,1038725,2021-03-22,Senate,"Do pass, but first be re-referred to the Committee on [Judiciary]",4,1,0,0,5
1439683,1053496,2021-04-13,Senate,"Do pass as amended, but first amend, and re-refer to the Committee on [Appropriations]",8,2,1,0,11
1439683,1068218,2021-05-03,Senate,"Placed on suspense file",6,0,1,0,7
1439684,1029550,2021-03-16,Senate,"Do pass, but first be re-referred to the Committee on [Appropriations]",9,0,0,0,9
1439684,1033625,2021-03-22,Senate,"Placed on suspense file",7,0,0,0,7
1439685,1037841,2021-03-25,Senate,"Do pass, but first be re-referred to the Committee on [Judiciary]",4,1,0,0,5
1439685,1059206,2021-04-20,Senate,"Do pass",10,0,1,0,11
1439685,1074177,2021-05-06,Senate,"Senate 3rd Reading SB323 Caballero et al",34,1,5,0,40
1439688,1026100,2021-03-10,Senate,"Do pass, but first be re-referred to the Committee on [Appropriations]",11,0,0,0,11
1439688,1074144,2021-05-06,Senate,"Senate 3rd Reading SB326 Pan et al",36,0,4,0,40
1439690,1047445,2021-04-07,Senate,"Do pass as amended, but first amend, and re-refer to the Committee on [Governance and Finance]",5,1,1,0,7
1439690,1060908,2021-04-22,Senate,"Do pass as amended, but first amend, and re-refer to the Committee on [Appropriations]",4,0,1,0,5
1439691,1025119,2021-03-09,Senate,"Do pass and be ordered to the Consent Calendar",11,0,0,0,11
1439691,1033621,2021-03-22,Senate,"Consent Calendar SB329",37,0,3,0,40
1441507,1054589,2021-04-15,Assembly,"Do pass and be re-referred to the Committee on [Appropriations] with recommendation: To Consent Calendar",7,0,0,0,7
1441507,1065232,2021-04-28,Assembly,"Do pass. To Consent Calendar",16,0,0,0,16
1441507,1074116,2021-05-06,Assembly,"AB 444 P.E. & R. Consent Calendar Second Day Regular Session",77,0,1,0,78
1441508,1047492,2021-04-07,Assembly,"Do pass and be re-referred to the Committee on [Appropriations] with recommendation: To Consent Calendar",8,0,0,0,8
1441508,1059215,2021-04-21,Assembly,"Do pass. To Consent Calendar",14,0,2,0,16
1441508,1066725,2021-04-29,Assembly,"AB 445 Calderon Consent Calendar Second Day Regular Session",77,0,1,0,78
1441509,1066724,2021-04-29,Assembly,"Do pass as amended and be re-referred to the Committee on [Appropriations]",6,0,1,0,7
1441510,1054688,2021-04-15,Assembly,"Do pass and be re-referred to the Committee on [Appropriations] with recommendation: To Consent Calendar",12,0,0,0,12
1441510,1065165,2021-04-28,Assembly,"Do pass. To Consent Calendar",16,0,0,0,16
1441510,1074132,2021-05-06,Assembly,"AB 447 Grayson Consent Calendar Second Day Regular Session",77,0,1,0,78
1441511,1059270,2021-04-21,Assembly,"Do pass and be re-referred to the Committee on [Natural Resources]",15,0,0,0,15
1441513,1051958,2021-04-13,Assembly,"Do pass and be re-referred to the Committee on [Emergency Management]",15,0,0,0,15
1441513,1057655,2021-04-19,Assembly,"Do pass. To Consent Calendar",6,0,1,0,7
1441514,1046220,2021-04-06,Assembly,"Do pass and be re-referred to the Committee on [Appropriations]",15,0,0,0,15
1441514,1053490,2021-04-14,Assembly,"Do pass. To Consent Calendar",16,0,0,0,16
1441514,1075289,2021-05-10,Assembly,"AB 451 Arambula Assembly Third Reading",73,0,5,0,78
1441516,1052012,2021-04-13,Assembly,"Do pass",11,0,0,0,11
1441516,1056490,2021-04-19,Assembly,"AB 453 Cristina Garcia Assembly Third Reading",74,0,5,0,79
1441517,1064004,2021-04-27,Assembly,"Do pass as amended and be re-referred to the Committee on [Appropriations]",10,1,4,0,15
1441518,1064027,2021-04-26,Assembly,"Do pass and be re-referred to the Committee on [Appropriations]",11,0,4,0,15
1441518,1076938,2021-05-12,Assembly,"Do pass",12,2,2,0,16
1441519,1049028,2021-04-08,Assembly,"Do pass and be re-referred to the Committee on [Appropriations] with recommendation: To Consent Calendar",22,0,0,0,22
1441520,1057631,2021-04-20,Assembly,"Do pass as amended and be re-referred to the Committee on [Appropriations]",13,0,2,0,15
1441522,1035170,2021-03-22,Assembly,"Do pass and be re-referred to the Committee on [Military and Veterans Affairs] with recommendation: To Consent Calendar",15,0,0,0,15
1441522,1065315,2021-04-28,Assembly,"Do pass and be re-referred to the Committee on [Appropriations] with recommendation: To Consent Calendar",11,0,0,0,11
1441524,1059273,2021-04-21,Assembly,"Do pass and be re-referred to the Committee on [Appropriations]",8,0,0,0,8
1441525,1057667,2021-04-20,Assembly,"Do pass and be re-referred to the Committee on [Appropriations] with recommendation: To Consent Calendar",19,0,0,0,19
1441525,1065105,2021-04-28,Assembly,"Do pass. To Consent Calendar",16,0,0,0,16
1441525,1074196,2021-05-06,Assembly,"AB 462 Carrillo Consent Calendar Second Day Regular Session",77,0,1,0,78
1441527,1054649,2021-04-14,Assembly,"Do pass. To Consent Calendar",8,0,0,0,8
1441527,1060948,2021-04-22,Assembly,"AB 464 Mullin Consent Calendar Second Day Regular Session",77,0,2,0,79
1441528,1046175,2021-04-06,Assembly,"Do pass and be re-referred to the Committee on [Appropriations]",18,0,1,0,19
1441528,1059335,2021-04-21,Assembly,"Do pass",14,0,2,0,16
1441528,1068238,2021-05-03,Assembly,"AB 465 Nazarian Assembly Third Reading",69,0,9,0,78
1441529,1035249,2021-03-22,Assembly,"Do pass and be re-referred to the Committee on [Appropriations]",9,0,2,0,11
1441529,1059309,2021-04-21,Assembly,"Do pass. To Consent Calendar",14,0,2,0,16
1441529,1066686,2021-04-29,Assembly,"AB 466 Petrie-Norris Consent Calendar Second Day Regular Session",77,0,1,0,78
1441531,1052011,2021-04-13,Assembly,"Do pass and be re-referred to the Committee on [Appropriations]",18,0,1,0,19
1441531,1073364,2021-05-05,Assembly,"Do pass. To Consent Calendar",16,0,0,0,16
1441531,1077584,2021-05-13,Assembly,"AB 468 Friedman Consent Calendar Second Day Regular Session",75,0,3,0,78
1441532,1048999,2021-04-07,Assembly,"Do pass and be re-referred to the Committee on [Appropriations]",7,0,0,0,7
1441533,1046147,2021-04-06,Assembly,"Do pass as amended and be re-referred to the Committee on [Appropriations]",12,0,3,0,15
1441534,1057681,2021-04-20,Assembly,"Do pass and be re-referred to the Committee on [Appropriations] with recommendation: To Consent Calendar",19,0,0,0,19
1441535,1050790,2021-04-12,Assembly,"Do pass and be re-referred to the Committee on [Privacy and Consumer Protection]",7,0,0,0,7
1441535,1060995,2021-04-22,Assembly,"Do pass and be re-referred to the Committee on [Appropriations] with recommendation: To Consent Calendar",11,0,0,0,11
1441535,1073377,2021-05-05,Assembly,"Do pass. To Consent Calendar",16,0,0,0,16
1441535,1077563,2021-05-13,Assembly,"AB 472 Cooley Consent Calendar Second Day Regular Session",75,0,3,0,78
1441536,1035247,2021-03-23,Assembly,"Do pass. To Consent Calendar",11,0,0,0,11
1441537,1035203,2021-03-23,Assembly,"Do pass. To Consent Calendar",11,0,0,0,11
1441538,1064169,2021-04-27,Assembly,"Do pass and be re-referred to the Committee on [Appropriations] with recommendation: To Consent Calendar",6,0,1,0,7
1441540,1047584,2021-04-07,Assembly,"Do pass as amended. To Consent Calendar",8,0,0,0,8
1441540,1056491,2021-04-19,Assembly,"AB 477 Blanca Rubio Consent Calendar Second Day",78,0,1,0,79
1441541,1053543,2021-04-14,Assembly,"Do pass and be re-referred to the Committee on [Judiciary]",8,0,3,0,11
1441541,1057742,2021-04-20,Assembly,"Do pass as amended and be re-referred to the Committee on [Appropriations]",8,1,2,0,11
1441542,1059330,2021-04-21,Assembly,"Do pass and be re-referred to the Committee on [Appropriations]",8,0,0,0,8
1441543,1047526,2021-04-07,Assembly,"Do pass and be re-referred to the Committee on [Appropriations]",6,1,2,0,9
1441544,1036472,2021-03-24,Assembly,"Do pass and be re-referred to the Committee on [Appropriations]",5,2,1,0,8
1441544,1037805,2021-03-24,Assembly,"Do pass and be re-referred to the Committee on [Public Safety]",5,2,1,0,8
1441544,1065158,2021-04-27,Assembly,"Do pass and be re-referred to the Committee on [Appropriations]",6,2,0,0,8
1441545,1029573,2021-03-15,Assembly,"Do pass as amended. To Consent Calendar",8,0,0,0,8
1441545,1037813,2021-03-25,Assembly,"AB 482 Ward Consent Calendar Second Day",74,0,4,0,78
1441546,1036425,2021-03-23,Assembly,"Do pass and be re-referred to the Committee on [Appropriations] with recommendation: To Consent Calendar",8,0,0,0,8
1441547,1051980,2021-04-13,Assembly,"Do pass and be re-referred to the Committee on [Appropriations]",17,0,2,0,19
1441547,1065205,2021-04-28,Assembly,"Do pass. To Consent Calendar",16,0,0,0,16
1441547,1074178,2021-05-06,Assembly,"AB 484 Medina Consent Calendar Second Day Regular Session",77,0,1,0,78
1441549,1065216,2021-04-28,Assembly,"Do pass and be re-referred to the Committee on [Appropriations] with recommendation: To Consent Calendar",7,0,0,0,7
1441551,1048947,2021-04-08,Assembly,"Do pass and be re-referred to the Committee on [Appropriations]",8,3,0,0,11
1441553,1053442,2021-04-13,Assembly,"Do pass and be re-referred to the Committee on [Appropriations]",6,2,0,0,8
1441554,1067615,2021-04-29,Assembly,"Do pass as amended and be re-referred to the Committee on [Appropriations]",7,0,1,0,8
1441554,1076937,2021-05-12,Assembly,"Do pass as amended. To Consent Calendar",16,0,0,0,16
1441555,1057619,2021-04-20,Assembly,"Do pass and be re-referred to the Committee on [Appropriations]",19,0,0,0,19
1441555,1065240,2021-04-28,Assembly,"Do pass. To Consent Calendar",16,0,0,0,16
1441555,1074115,2021-05-06,Assembly,"AB 492 Patterson Consent Calendar Second Day Regular Session",77,0,1,0,78
1441556,1035267,2021-03-23,Assembly,"Do pass",13,1,1,0,15
1441556,1048984,2021-04-08,Assembly,"AB 493 Wood Assembly Third Reading",62,2,14,0,78
1441557,1027161,2021-03-11,Assembly,"Be adopted. To third reading",8,0,4,0,12
1441557,1050803,2021-04-12,Senate,"Assembly 3rd Reading ACR23 Villapudua et al",39,0,1,0,40
1441558,1035190,2021-03-23,Assembly,"Be adopted, and re-refer to the Committee on [Appropriations] with recommendation: To Consent Calendar",11,0,0,0,11
1441558,1053524,2021-04-14,Assembly,"Be adopted. To Consent Calendar",16,0,0,0,16
1441558,1056497,2021-04-19,Assembly,"ACR 24 Chau Consent Calendar Second Day Regular Session",78,0,1,0,79
1441559,1074153,2021-05-06,Assembly,"Be adopted. To Consent Calendar",11,0,1,0,12
1441559,1077579,2021-05-13,Assembly,"ACR 25 Nguyen Consent Calendar Second Day Regular Session",75,0,3,0,78
1441561,1027167,2021-03-11,Assembly,"Be adopted. To third reading",8,0,4,0,12
1441562,1060943,2021-04-22,Assembly,"Be adopted. To third reading",12,0,0,0,12
1441563,1026101,2021-03-10,Senate,"Do pass as amended, but first amend, and re-refer to the Committee on [Appropriations]",5,1,1,0,7
1441563,1044940,2021-04-05,Senate,"Placed on suspense file",7,0,0,0,7
1441564,1053413,2021-04-13,Senate,"Do pass as amended, but first amend, and re-refer to the Committee on [Appropriations]",8,2,1,0,11
1441564,1074165,2021-05-06,Senate,"Senate 3rd Reading SB331 Leyva",29,8,3,0,40
1441565,1072215,2021-05-04,Senate,"Do pass as amended",11,0,0,0,11
1441566,1051929,2021-04-13,Senate,"Do pass, but first be re-referred to the Committee on [Appropriations] with the recommendation: To Consent Calendar",16,0,1,0,17
1441566,1075255,2021-05-10,Senate,"Consent Calendar SB333",37,0,3,0,40
1441567,1037811,2021-03-25,Senate,"Do pass, but first be re-referred to the Committee on [Judiciary]",8,1,3,0,12
1441567,1059179,2021-04-20,Senate,"Do pass, but first be re-referred to the Committee on [Appropriations]",9,2,0,0,11
1441568,1064048,2021-04-26,Senate,"Do pass, but first be re-referred to the Committee on [Appropriations]",4,1,0,0,5
1441568,1075340,2021-05-10,Senate,"Placed on suspense file",7,0,0,0,7
1441569,1065159,2021-04-28,Senate,"Do pass as amended, but first amend, and re-refer to the Committee on [Appropriations]",11,0,0,0,11
1441571,1046174,2021-04-05,Senate,"Do pass, but first be re-referred to the Committee on [Judiciary]",4,1,0,0,5
1441571,1059158,2021-04-20,Senate,"Do pass as amended, but first amend, and re-refer to the Committee on [Appropriations]",9,2,0,0,11
1441571,1068275,2021-05-03,Senate,"Placed on suspense file",6,0,1,0,7
1441572,1052031,2021-04-13,Senate,"Do pass, but first be re-referred to the Committee on [Appropriations]",10,4,3,0,17
1441572,1068254,2021-05-03,Senate,"Placed on suspense file",6,0,1,0,7
1444422,1054584,2021-04-15,Assembly,"Do pass and be re-referred to the Committee on [Appropriations] with recommendation: To Consent Calendar",13,0,0,0,13
1444422,1065200,2021-04-28,Assembly,"Do pass. To Consent Calendar",16,0,0,0,16
1444422,1074117,2021-05-06,Assembly,"AB 494 Mayes Consent Calendar Second Day Regular Session",77,0,1,0,78
1444423,1048911,2021-04-08,Assembly,"Do pass and be re-referred to the Committee on [Appropriations] with recommendation: To Consent Calendar",22,0,0,0,22
1444423,1059153,2021-04-21,Assembly,"Do pass. To Consent Calendar",14,0,2,0,16
1444423,1066717,2021-04-29,Assembly,"AB 495 Bigelow Consent Calendar Second Day Regular Session",77,0,1,0,78
1444424,1035256,2021-03-23,Assembly,"Do pass. To Consent Calendar",17,0,2,0,19
1444424,1044942,2021-04-05,Assembly,"AB 496 Chen Consent Calendar Second Day Regular Session",74,0,4,0,78
1444426,1048893,2021-04-07,Assembly,"Do pass as amended, and be re-referred to the Committee on [Appropriations] with recommendation: To Consent Calendar",7,0,0,0,7
1444427,1047569,2021-04-07,Assembly,"Do pass and be re-referred to the Committee on [Aging and Long-Term Care]",8,0,0,0,8
1444427,1057639,2021-04-20,Assembly,"Do pass and be re-referred to the Committee on [Appropriations]",7,0,0,0,7
1444428,1065154,2021-04-28,Assembly,"Do pass and be re-referred to the Committee on [Housing and Community Development]",7,3,1,0,11
1444428,1067631,2021-04-29,Assembly,"Do pass and be re-referred to the Committee on [Appropriations]",6,2,0,0,8
1444429,1057629,2021-04-20,Assembly,"Do pass and be re-referred to the Committee on [Appropriations] with recommendation: To Consent Calendar",19,0,0,0,19
1444430,1067630,2021-04-29,Assembly,"Do pass as amended and be re-referred to the Committee on [Appropriations]",8,0,0,0,8
1444431,1036486,2021-03-23,Assembly,"Do pass",6,2,0,0,8
1444431,1053502,2021-04-12,Assembly,"AB 503 Stone Assembly Third Reading",35,22,21,0,78
1444431,1056492,2021-04-19,Assembly,"AB 503 Stone Assembly Third Reading",41,22,16,0,79
1444432,1036452,2021-03-24,Assembly,"Do pass and be re-referred to the Committee on [Appropriations] with recommendation: To Consent Calendar",11,0,0,0,11
1444432,1053530,2021-04-14,Assembly,"Do pass. To Consent Calendar",16,0,0,0,16
1444432,1060910,2021-04-22,Assembly,"AB 504 McCarty Consent Calendar Second Day Regular Session",77,0,2,0,79
1444434,1065282,2021-04-27,Assembly,"Do pass as amended and be re-referred to the Committee on [Appropriations]",8,0,0,0,8
1444434,1076932,2021-05-12,Assembly,"Do pass",16,0,0,0,16
1444439,1066809,2021-04-29,Assembly,"Do pass and be re-referred to the Committee on [Appropriations]",12,0,0,0,12
1444440,1054761,2021-04-15,Assembly,"Do pass and be re-referred to the Committee on [Appropriations]",8,0,0,0,8
1444442,1072280,2021-05-04,Assembly,"Do pass. To Consent Calendar",11,0,0,0,11
1444442,1075300,2021-05-10,Assembly,"AB 514 Ward Consent Calendar Second Day Regular Session",74,0,4,0,78
1444443,1036469,2021-03-23,Assembly,"Do pass as amended, and be re-referred to the Committee on [Appropriations] with recommendation: To Consent Calendar",8,0,0,0,8
1444443,1053570,2021-04-14,Assembly,"Do pass",16,0,0,0,16
1444443,1056493,2021-04-19,Assembly,"AB 515 Chen Assembly Third Reading",78,0,1,0,79
1444444,1056345,2021-04-19,Assembly,"Be adopted. To Consent Calendar",15,0,0,0,15
1444444,1060986,2021-04-22,Assembly,"ACR 27 Gallagher Consent Calendar Second Day Regular Session",77,0,2,0,79
1444445,1059204,2021-04-21,Senate,"Do pass as amended, but first amend, and re-refer to the Committee on [Judiciary]",11,0,0,0,11
1444445,1072197,2021-05-04,Senate,"Do pass and be ordered to the Consent Calendar",11,0,0,0,11
1444445,1075352,2021-05-10,Senate,"Consent Calendar SB340",37,0,3,0,40
1444446,1028433,2021-03-15,Senate,"Do pass as amended, but first amend, and re-refer to the Committee on [Governmental Organization]",13,0,1,0,14
1444446,1046166,2021-04-06,Senate,"Do pass, but first be re-referred to the Committee on [Appropriations]",13,1,1,0,15
1444446,1068220,2021-05-03,Senate,"Do pass",5,0,2,0,7
1444446,1077603,2021-05-13,Senate,"Senate 3rd Reading SB341 McGuire et al",37,0,3,0,40
1444447,1050839,2021-04-12,Senate,"Do pass, but first be re-referred to the Committee on [Governance and Finance]",5,0,2,0,7
1444447,1074161,2021-05-06,Senate,"Do pass",3,1,1,0,5
1444448,1028426,2021-03-15,Senate,"Do pass as amended, but first amend, and re-refer to the Committee on [Judiciary]",5,0,2,0,7
1444448,1047530,2021-04-06,Senate,"Do pass as amended, but first amend, and re-refer to the Committee on [Appropriations]",9,0,2,0,11
1444448,1056420,2021-04-19,Senate,"Placed on suspense file",7,0,0,0,7
1444449,1031915,2021-03-18,Senate,"Do pass as amended, but first amend, and re-refer to the Committee on [Appropriations]",8,0,1,0,9
1444449,1045019,2021-04-05,Senate,"Placed on suspense file",7,0,0,0,7
1444450,1028423,2021-03-15,Senate,"Do pass as amended, but first amend, and re-refer to the Committee on [Appropriations]",10,2,2,0,14
1444450,1044962,2021-04-05,Senate,"Placed on suspense file",7,0,0,0,7
1444451,1029554,2021-03-16,Senate,"Do pass, but first be re-referred to the Committee on [Appropriations]",10,1,0,0,11
1444451,1044995,2021-04-05,Senate,"Placed on suspense file",7,0,0,0,7
1444452,1029551,2021-03-16,Senate,"Do pass as amended, but first amend, and re-refer to the Committee on [Governance and Finance]",9,0,0,0,9
1444452,1037816,2021-03-25,Senate,"Do pass, but first be re-referred to the Committee on [Appropriations] with the recommendation: To Consent Calendar",5,0,0,0,5
1444452,1060940,2021-04-22,Senate,"Consent Calendar SB347",38,0,2,0,40
1444453,1053484,2021-04-14,Senate,"Do pass, but first be re-referred to the Committee on [Appropriations]",7,0,0,0,7
1444453,1068235,2021-05-03,Senate,"Placed on suspense file",6,0,1,0,7
1444454,1030780,2021-03-17,Senate,"Do pass, but first be re-referred to the Committee on [Judiciary]",10,0,1,0,11
1444454,1047456,2021-04-06,Senate,"Do pass as amended, but first amend, and re-refer to the Committee on [Appropriations] with the recommendation: To Consent Calendar",11,0,0,0,11
1444454,1068225,2021-05-03,Senate,"Placed on suspense file",6,0,1,0,7
1444455,1035201,2021-03-23,Senate,"Do pass, but first be re-referred to the Committee on [Appropriations]",1,1,3,0,5
1444455,1035202,2021-03-23,Senate,"[First] hearing set for [03-23-2021]: Failed passage in Committee. Reconsideration granted",5,0,0,0,5
1444456,1054739,2021-04-15,Senate,"Do pass as amended, but first amend, and re-refer to the Committee on [Appropriations]",9,0,0,0,9
1444456,1075337,2021-05-10,Senate,"Placed on suspense file",7,0,0,0,7
1444457,1030825,2021-03-17,Senate,"Do pass, but first be re-referred to the Committee on [Judiciary]",7,0,0,0,7
1444457,1047585,2021-04-06,Senate,"Do pass as amended, but first amend, and re-refer to the Committee on [Appropriations] with the recommendation: To Consent Calendar",11,0,0,0,11
1444457,1060869,2021-04-22,Senate,"Consent Calendar SB352",38,0,2,0,40
1444458,1026087,2021-03-10,Senate,"Do pass, but first be re-referred to the Committee on [Appropriations] with the recommendation: To Consent Calendar",11,0,0,0,11
1444458,1060958,2021-04-22,Senate,"Consent Calendar SB353",38,0,2,0,40
1444459,1046086,2021-04-06,Senate,"Do pass, but first be re-referred to the Committee on [Judiciary]",4,0,1,0,5
1444459,1065223,2021-04-27,Senate,"Do pass as amended, but first amend, and re-refer to the Committee on [Appropriations] with the recommendation: To Consent Calendar",11,0,0,0,11
1444459,1075382,2021-05-10,Senate,"Placed on suspense file",7,0,0,0,7
1444460,1029569,2021-03-16,Senate,"Do pass as amended, but first amend, and re-refer to the Committee on [Appropriations] with the recommendation: To Consent Calendar",11,0,0,0,11
1444460,1044977,2021-04-05,Senate,"Placed on suspense file",7,0,0,0,7
1444462,1051989,2021-04-13,Senate,"Do pass, but first be re-referred to the Committee on [Appropriations]",4,1,0,0,5
1444462,1068190,2021-05-03,Senate,"Placed on suspense file",6,0,1,0,7
1444463,1051947,2021-04-13,Senate,"Do pass as amended, but first amend, and re-refer to the Committee on [Appropriations]",4,0,1,0,5
1444463,1068209,2021-05-03,Senate,"Placed on suspense file",6,0,1,0,7
1444464,1054655,2021-04-15,Senate,"Do pass as amended, but first amend, and re-refer to the Committee on [Appropriations]",9,0,0,0,9
1444464,1068172,2021-05-03,Senate,"Placed on suspense file",6,0,1,0,7
1444465,1022331,2021-03-04,Senate,"Senate 3rd Reading SCR13 Pan",34,0,5,0,39
1444465,1060872,2021-04-22,Assembly,"Be adopted. To Consent Calendar",12,0,0,0,12
1444465,1066732,2021-04-29,Assembly,"SCR 13 Pan Consent Calendar Second Day Regular Session",77,0,1,0,78
1447122,1036526,2021-03-24,Assembly,"Do pass and be re-referred to the Committee on [Appropriations] with recommendation: To Consent Calendar",7,0,0,0,7
1447123,1049887,2021-04-08,Assembly,"Do pass and be re-referred to the Committee on [Appropriations]",12,0,3,0,15
1447124,1036447,2021-03-23,Assembly,"Do pass and be re-referred to the Committee on [Appropriations]",6,2,0,0,8
1447124,1053512,2021-04-14,Assembly,"Do pass",12,4,0,0,16
1447124,1075280,2021-05-10,Assembly,"AB 518 Wicks Assembly Third Reading",41,23,14,0,78
1447125,1066795,2021-04-29,Assembly,"Do pass and be re-referred to the Committee on [Appropriations] with recommendation: To Consent Calendar",11,0,0,0,11
1447126,1048901,2021-04-07,Assembly,"Do pass as amended and be re-referred to the Committee on [Appropriations]",7,0,0,0,7
1447127,1046151,2021-04-06,Assembly,"Do pass and be re-referred to the Committee on [Appropriations] with recommendation: To Consent Calendar",15,0,0,0,15
1447129,1046144,2021-04-06,Assembly,"Do pass and be re-referred to the Committee on [Health]",6,0,1,0,7
1447129,1064176,2021-04-27,Assembly,"Do pass as amended and be re-referred to the Committee on [Appropriations]",15,0,0,0,15
1447130,1060904,2021-04-22,Assembly,"Do pass and be re-referred to the Committee on [Appropriations]",11,0,1,0,12
1447130,1073351,2021-05-05,Assembly,"Do pass",16,0,0,0,16
1447131,1059202,2021-04-21,Assembly,"Do pass as amended and be re-referred to the Committee on [Natural Resources]",14,0,1,0,15
1447131,1065249,2021-04-28,Assembly,"Do pass and be re-referred to the Committee on [Appropriations]",11,0,0,0,11
1447132,1051906,2021-04-13,Assembly,"Do pass and be re-referred to the Committee on [Appropriations]",18,0,1,0,19
1447132,1065252,2021-04-28,Assembly,"Do pass. To Consent Calendar",16,0,0,0,16
1447132,1074145,2021-05-06,Assembly,"AB 526 Wood Consent Calendar Second Day Regular Session",77,0,1,0,78
1447133,1052023,2021-04-13,Assembly,"Do pass",17,0,2,0,19
1447133,1060875,2021-04-22,Assembly,"AB 527 Wood Consent Calendar Second Day Regular Session",77,0,2,0,79
1447134,1064075,2021-04-26,Assembly,"Do pass as amended and be re-referred to the Committee on [Appropriations]",7,2,2,0,11
1447138,1046141,2021-04-06,Assembly,"Do pass and be re-referred to the Committee on [Appropriations] with recommendation: To Consent Calendar",15,0,0,0,15
1447138,1053485,2021-04-14,Assembly,"Do pass. To Consent Calendar",16,0,0,0,16
1447138,1060888,2021-04-22,Assembly,"AB 532 Wood Consent Calendar Second Day Regular Session",77,0,2,0,79
1447141,1051944,2021-04-13,Assembly,"Do pass and be re-referred to the Committee on [Appropriations]",13,0,2,0,15
1447141,1059318,2021-04-21,Assembly,"Do pass",11,3,2,0,16
1447142,1057718,2021-04-19,Assembly,"Do pass. To Consent Calendar",6,0,1,0,7
1447142,1073390,2021-05-05,Assembly,"Do pass. To Consent Calendar",16,0,0,0,16
1447142,1077526,2021-05-13,Assembly,"AB 536 Rodriguez Consent Calendar Second Day Regular Session",75,0,3,0,78
1447143,1054595,2021-04-14,Assembly,"Do pass and be re-referred to the Committee on [Communications and Conveyance]",8,0,0,0,8
1447143,1065094,2021-04-28,Assembly,"Do pass and be re-referred to the Committee on [Appropriations]",13,0,0,0,13
1447144,1064114,2021-04-27,Assembly,"Do pass as amended and be re-referred to the Committee on [Appropriations]",6,0,1,0,7
1447145,1054662,2021-04-15,Assembly,"Do pass and be re-referred to the Committee on [Appropriations]",7,0,0,0,7
1447145,1065260,2021-04-28,Assembly,"Do pass. To Consent Calendar",16,0,0,0,16
1447145,1074169,2021-05-06,Assembly,"AB 539 Cooley Consent Calendar Second Day Regular Session",77,0,1,0,78
1447146,1046173,2021-04-06,Assembly,"Do pass and be re-referred to the Committee on [Health]",7,0,0,0,7
1447146,1057774,2021-04-20,Assembly,"Do pass as amended and be re-referred to the Committee on [Appropriations]",15,0,0,0,15
1447147,1035199,2021-03-23,Assembly,"Do pass and be re-referred to the Committee on [Appropriations] with recommendation: To Consent Calendar",15,0,0,0,15
1447148,1049878,2021-04-08,Assembly,"Do pass and be re-referred to the Committee on [Appropriations]",15,0,0,0,15
1447149,1036548,2021-03-24,Assembly,"Do pass as amended and be re-referred to the Committee on [Appropriations]",12,0,0,0,12
1447149,1053444,2021-04-14,Assembly,"Do pass. To Consent Calendar",16,0,0,0,16
1447149,1060965,2021-04-22,Assembly,"AB 543 Davies Consent Calendar Second Day Regular Session",77,0,2,0,79
1447150,1036502,2021-03-24,Assembly,"Do pass as amended and be re-referred to the Committee on [Appropriations]",7,0,0,0,7
1447151,1064091,2021-04-26,Assembly,"Do pass as amended and be re-referred to the Committee on [Appropriations]",7,2,2,0,11
1447152,1047558,2021-04-07,Assembly,"Do pass and be re-referred to the Committee on [Judiciary] with recommendation: To Consent Calendar",8,0,0,0,8
1447152,1052005,2021-04-13,Assembly,"Do pass and be re-referred to the Committee on [Appropriations] with recommendation: To Consent Calendar",11,0,0,0,11
1447152,1065268,2021-04-28,Assembly,"Do pass. To Consent Calendar",16,0,0,0,16
1447152,1074183,2021-05-06,Assembly,"AB 546 Maienschein Consent Calendar Second Day Regular Session",77,0,1,0,78
1447153,1036506,2021-03-23,Assembly,"Do pass and be re-referred to the Committee on [Appropriations] with recommendation: To Consent Calendar",8,0,0,0,8
1447155,1047554,2021-04-07,Assembly,"Do pass and be re-referred to the Committee on [Judiciary]",8,0,0,0,8
1447155,1052019,2021-04-13,Assembly,"Do pass and be re-referred to the Committee on [Appropriations]",11,0,0,0,11
1447156,1064162,2021-04-26,Assembly,"Do pass as amended and be re-referred to the Committee on [Appropriations]",13,0,2,0,15
1447157,1054666,2021-04-15,Assembly,"Do pass and be re-referred to the Committee on [Appropriations]",4,2,1,0,7
1447157,1073447,2021-05-05,Assembly,"Do pass",12,4,0,0,16
1447158,1036499,2021-03-24,Assembly,"Do pass as amended and be re-referred to the Committee on [Health]",7,0,0,0,7
1447160,1049890,2021-04-08,Assembly,"Do pass and be re-referred to the Committee on [Appropriations]",8,5,2,0,15
1447162,1005314,2021-02-12,Assembly,"Be adopted. To Consent Calendar",11,0,1,0,12
1447162,1009553,2021-02-18,Assembly,"ACR 28 Calderon Consent Calendar Second Day Regular Session",68,0,11,0,79
1447162,1037847,2021-03-25,Senate,"Special Consent ACR28",38,0,2,0,40
1447163,1005304,2021-02-12,Assembly,"Be adopted. To third reading",11,0,1,0,12
1447164,1026107,2021-03-10,Senate,"Do pass, but first be re-referred to the Committee on [Judiciary]",9,0,0,0,9
1447164,1035153,2021-03-23,Senate,"Do pass, but first be re-referred to the Committee on [Appropriations] with the recommendation: To Consent Calendar",11,0,0,0,11
1447164,1045016,2021-04-05,Senate,"Placed on suspense file",7,0,0,0,7
1447165,1047448,2021-04-06,Senate,"Do pass",10,1,0,0,11
1447165,1066834,2021-04-29,Senate,"Senate 3rd Reading SB361 Umberg",36,0,4,0,40
1447166,1033626,2021-03-22,Senate,"Do pass, but first be re-referred to the Committee on [Appropriations]",9,3,2,0,14
1447166,1044982,2021-04-05,Senate,"Placed on suspense file",7,0,0,0,7
1447167,1053425,2021-04-14,Senate,"Do pass, but first be re-referred to the Committee on [Rules]",4,1,2,0,7
1447167,1072243,2021-05-04,Senate,"Do pass as amended",9,0,2,0,11
1447168,1047452,2021-04-07,Senate,"Do pass as amended, but first amend, and re-refer to the Committee on [Human Services]",7,0,0,0,7
1447168,1057707,2021-04-20,Senate,"Do pass, but first be re-referred to the Committee on [Appropriations]",5,0,0,0,5
1447168,1075270,2021-05-10,Senate,"Placed on suspense file",7,0,0,0,7
1447169,1036437,2021-03-24,Senate,"Do pass, but first be re-referred to the Committee on [Appropriations]",11,0,0,0,11
1447170,1052013,2021-04-13,Senate,"Do pass, but first be re-referred to the Committee on [Appropriations] with the recommendation: To Consent Calendar",16,0,1,0,17
1447170,1068263,2021-05-03,Senate,"Placed on suspense file",6,0,1,0,7
1447171,1030826,2021-03-17,Senate,"Do pass as amended, but first amend, and re-refer to the Committee on [Health]",7,0,0,0,7
1447171,1047429,2021-04-07,Senate,"Do pass as amended, but first amend, and re-refer to the Committee on [Appropriations] with the recommendation: To Consent Calendar",11,0,0,0,11
1447171,1075294,2021-05-10,Senate,"Consent Calendar SB367",37,0,3,0,40
1447172,1030787,2021-03-17,Senate,"Do pass as amended, but first amend, and re-refer to the Committee on [Appropriations]",9,2,0,0,11
1447172,1056412,2021-04-19,Senate,"Placed on suspense file",7,0,0,0,7
1447173,1029556,2021-03-16,Senate,"Do pass, but first be re-referred to the Committee on [Appropriations] with the recommendation: To Consent Calendar",9,0,0,0,9
1447173,1037807,2021-03-25,Senate,"Consent Calendar SB369",38,0,2,0,40
1447174,1064084,2021-04-27,Senate,"Do pass as amended, but first amend, and re-refer to the Committee on [Appropriations] with the recommendation: To Consent Calendar",9,0,0,0,9
1447175,1036445,2021-03-24,Senate,"Do pass, but first be re-referred to the Committee on [Appropriations]",11,0,0,0,11
1447175,1056323,2021-04-19,Senate,"Placed on suspense file",7,0,0,0,7
1447176,1050830,2021-04-12,Senate,"Do pass as amended, but first amend, and re-refer to the Committee on [Transportation]",6,1,0,0,7
1447176,1064039,2021-04-27,Senate,"Do pass, but first be re-referred to the Committee on [Appropriations]",16,0,1,0,17
1447176,1075323,2021-05-10,Senate,"Placed on suspense file",7,0,0,0,7
1447178,1035184,2021-03-23,Senate,"Do pass, but first be re-referred to the Committee on [Appropriations]",11,0,0,0,11
1447178,1066688,2021-04-29,Senate,"Senate 3rd Reading SB374 Min et al",37,0,3,0,40
1447180,1054691,2021-04-15,Senate,"Do pass, but first be re-referred to the Committee on [Public Safety]",7,0,2,0,9
1447180,1064136,2021-04-27,Senate,"Do pass as amended, but first amend, and re-refer to the Committee on [Appropriations]",5,0,0,0,5
1447181,1023845,2021-03-08,Senate,"Do pass, but first be re-referred to the Committee on [Public Safety]",8,2,4,0,14
1447182,1048966,2021-04-08,Senate,"Do pass as amended, but first amend, and re-refer to the Committee on [Energy, Utilities and Communications]",5,0,0,0,5
1447182,1062770,2021-04-26,Senate,"Do pass as amended, but first amend, and re-refer to the Committee on [Appropriations]",13,0,1,0,14
1447183,1030775,2021-03-17,Senate,"Do pass, but first be re-referred to the Committee on [Health]",5,2,0,0,7
1447183,1059219,2021-04-21,Senate,"Do pass, but first be re-referred to the Committee on [Appropriations]",9,2,0,0,11
1447183,1075378,2021-05-10,Senate,"Placed on suspense file",7,0,0,0,7
1447184,1036424,2021-03-24,Senate,"Do pass as amended, but first amend, and re-refer to the Committee on [Judiciary]",8,1,2,0,11
1447184,1059341,2021-04-20,Senate,"Do pass as amended, but first amend, and re-refer to the Committee on [Appropriations]",9,1,1,0,11
1447185,1064138,2021-04-27,Senate,"Do pass as amended, but first amend, and re-refer to the Committee on [Appropriations]",16,0,1,0,17
1447186,1046183,2021-04-06,Senate,"Do pass, but first be re-referred to the Committee on [Appropriations]",5,0,0,0,5
1447186,1056342,2021-04-19,Senate,"Placed on suspense file",7,0,0,0,7
1447187,1051962,2021-04-13,Senate,"Do pass, but first be re-referred to the Committee on [Appropriations]",5,0,0,0,5
1447188,1025123,2021-03-09,Senate,"Do pass as amended, but first amend, and re-refer to the Committee on [Public Safety]",4,0,0,0,4
1447188,1051994,2021-04-13,Senate,"Do pass, but first be re-referred to the Committee on [Appropriations] with the recommendation: To Consent Calendar",5,0,0,0,5
1447188,1075241,2021-05-10,Senate,"Consent Calendar SB384",37,0,3,0,40
1447189,1035194,2021-03-23,Senate,"Do pass, but first be re-referred to the Committee on [Appropriations] with the recommendation: To Consent Calendar",5,0,0,0,5
1447189,1044971,2021-04-05,Senate,"Placed on suspense file",7,0,0,0,7
1450050,1035161,2021-03-23,Assembly,"Do pass",10,1,0,0,11
1450050,1044967,2021-04-05,Assembly,"AB 556 Maienschein Assembly Third Reading",68,0,10,0,78
1450051,1059230,2021-04-20,Assembly,"Do pass and be re-referred to the Committee on [Appropriations]",8,0,0,0,8
1450053,1036480,2021-03-24,Assembly,"Do pass and be re-referred to the Committee on [Governmental Organization]",8,0,3,0,11
1450053,1060825,2021-04-22,Assembly,"Do pass and be re-referred to the Committee on [Appropriations]",13,5,4,0,22
1450055,1067628,2021-04-29,Assembly,"Do pass and be re-referred to the Committee on [Appropriations]",5,0,3,0,8
1450056,1046145,2021-04-06,Assembly,"Do pass as amended and be re-referred to the Committee on [Health]",18,0,1,0,19
1450057,1036435,2021-03-24,Assembly,"Do pass as amended and be re-referred to the Committee on [Health]",7,0,0,0,7
1450057,1051886,2021-04-13,Assembly,"Do pass and be re-referred to the Committee on [Appropriations] with recommendation: To Consent Calendar",15,0,0,0,15
1450059,1048987,2021-04-08,Assembly,"Do pass and be re-referred to the Committee on [Appropriations] with recommendation: To Consent Calendar",7,0,0,0,7
1450062,1047533,2021-04-07,Assembly,"Do pass and be re-referred to the Committee on [Education] with recommendation: To Consent Calendar",8,0,0,0,8
1450062,1065151,2021-04-28,Assembly,"Do pass as amended and be re-referred to the Committee on [Appropriations]",7,0,0,0,7
1450063,1035181,2021-03-23,Assembly,"Do pass and be re-referred to the Committee on [Appropriations]",17,0,2,0,19
1450063,1053547,2021-04-14,Assembly,"Do pass. To Consent Calendar",16,0,0,0,16
1450063,1060976,2021-04-22,Assembly,"AB 569 Grayson Consent Calendar Second Day Regular Session",77,0,2,0,79
1450064,1064038,2021-04-27,Assembly,"Do pass and be re-referred to the Committee on [Appropriations]",10,2,3,0,15
1450065,1054751,2021-04-15,Assembly,"Do pass and be re-referred to the Committee on [Local Government]",8,0,0,0,8
1450065,1065185,2021-04-28,Assembly,"Do pass as amended and be re-referred to the Committee on [Appropriations]",8,0,0,0,8
1450066,1060843,2021-04-22,Assembly,"Do pass and be re-referred to the Committee on [Appropriations]",5,2,0,0,7
1450067,1035208,2021-03-23,Assembly,"Do pass and be re-referred to the Committee on [Appropriations]",14,0,1,0,15
1450070,1036504,2021-03-24,Assembly,"Do pass as amended and be re-referred to the Committee on [Appropriations]",12,0,0,0,12
1450073,1065258,2021-04-28,Assembly,"Do pass and be re-referred to the Committee on [Appropriations]",11,0,0,0,11
1450074,1057661,2021-04-19,Assembly,"Do pass. To Consent Calendar",6,0,1,0,7
1450074,1073340,2021-05-05,Assembly,"Do pass. To Consent Calendar",16,0,0,0,16
1450074,1077612,2021-05-13,Assembly,"AB 580 Rodriguez Consent Calendar Second Day Regular Session",75,0,3,0,78
1450075,1048969,2021-04-08,Assembly,"Do pass and be re-referred to the Committee on [Accountability and Administrative Review] with recommendation: To Consent Calendar",11,0,0,0,11
1450075,1065245,2021-04-28,Assembly,"Do pass and be re-referred to the Committee on [Appropriations]",7,0,0,0,7
1450076,1047547,2021-04-06,Assembly,"Do pass and be re-referred to the Committee on [Appropriations]",7,1,0,0,8
1450077,1035197,2021-03-23,Assembly,"Do pass",11,0,0,0,11
1450079,1036543,2021-03-24,Assembly,"Do pass and be re-referred to the Committee on [Appropriations]",9,0,2,0,11
1450080,1048982,2021-04-07,Assembly,"Do pass and be re-referred to the Committee on [Health]",7,0,0,0,7
1450080,1051976,2021-04-13,Assembly,"Do pass as amended and be re-referred to the Committee on [Appropriations]",15,0,0,0,15
1450081,1060824,2021-04-22,Assembly,"Do pass and be re-referred to the Committee on [Judiciary]",9,0,2,0,11
1450081,1064105,2021-04-27,Assembly,"Do pass as amended and be re-referred to the Committee on [Appropriations]",10,0,1,0,11
1450085,1035232,2021-03-22,Assembly,"Do pass and be re-referred to the Committee on [Appropriations] with recommendation: To Consent Calendar",15,0,0,0,15
1450085,1053565,2021-04-14,Assembly,"Do pass. To Consent Calendar",16,0,0,0,16
1450085,1060916,2021-04-22,Assembly,"AB 591 Villapudua Consent Calendar Second Day Regular Session",77,0,2,0,79
1450086,1059191,2021-04-21,Assembly,"Do pass and be re-referred to the Committee on [Appropriations] with recommendation: To Consent Calendar",8,0,0,0,8
1450087,1051959,2021-04-12,Assembly,"Do pass as amended and be re-referred to the Committee on [Appropriations]",9,0,2,0,11
1450088,1036532,2021-03-23,Assembly,"Do pass and be re-referred to the Committee on [Appropriations]",5,1,2,0,8
1450089,1036444,2021-03-24,Assembly,"Do pass and be re-referred to the Committee on [Appropriations]",11,1,0,0,12
1450093,1048904,2021-04-07,Assembly,"Do pass as amended and be re-referred to the Committee on [Appropriations]",7,0,0,0,7
1450093,1065288,2021-04-28,Assembly,"Do pass. To Consent Calendar",16,0,0,0,16
1450093,1074131,2021-05-06,Assembly,"AB 599 Jones-Sawyer Consent Calendar Second Day Regular Session",77,0,1,0,78
1450094,1047593,2021-04-06,Assembly,"Do pass as amended and be re-referred to the Committee on [Appropriations]",7,0,1,0,8
1450096,1054590,2021-04-14,Assembly,"Do pass as amended and be re-referred to the Committee on [Housing and Community Development]",8,0,0,0,8
1450096,1067632,2021-04-29,Assembly,"Do pass as amended and be re-referred to the Committee on [Appropriations]",7,0,1,0,8
1450097,1047495,2021-04-06,Assembly,"Do pass and be re-referred to the Committee on [Appropriations] with recommendation: To Consent Calendar",8,0,0,0,8
1450097,1065136,2021-04-28,Assembly,"Do pass. To Consent Calendar",16,0,0,0,16
1450097,1074118,2021-05-06,Assembly,"AB 603 McCarty Consent Calendar Second Day Regular Session",77,0,1,0,78
1450098,1044989,2021-04-05,Assembly,"Do pass and be re-referred to the Committee on [Appropriations] with recommendation: To Consent Calendar",14,0,1,0,15
1450100,1025101,2021-03-09,Senate,"Do pass, but first be re-referred to the Committee on [Appropriations]",12,0,2,0,14
1450100,1062769,2021-04-26,Senate,"Senate 3rd Reading SB386 Umberg",37,1,2,0,40
1450101,1057674,2021-04-20,Senate,"Do pass as amended, but first amend, and re-refer to the Committee on [Appropriations]",5,0,0,0,5
1450101,1075258,2021-05-10,Senate,"Placed on suspense file",7,0,0,0,7
1450103,1057733,2021-04-20,Senate,"Do pass as amended, but first amend, and re-refer to the Committee on [Appropriations]",15,0,0,0,15
1450103,1075302,2021-05-10,Senate,"Senate 3rd Reading SB389 Dodd et al",36,0,4,0,40
1450104,1056408,2021-04-19,Senate,"Do pass, but first be re-referred to the Committee on [Appropriations] with the recommendation: To Consent Calendar",5,0,0,0,5
1450104,1075342,2021-05-10,Senate,"Placed on suspense file",7,0,0,0,7
1450105,1031894,2021-03-18,Senate,"Do pass as amended, but first amend, and re-refer to the Committee on [Judiciary]",6,0,3,0,9
1450105,1047474,2021-04-06,Senate,"Do pass as amended",10,1,0,0,11
1450105,1066825,2021-04-29,Senate,"Senate 3rd Reading SB391 Min Urgency Clause",35,1,4,0,40
1450106,1054677,2021-04-15,Senate,"Do pass, but first be re-referred to the Committee on [Judiciary]",8,0,1,0,9
1450106,1065303,2021-04-27,Senate,"Do pass as amended",10,1,0,0,11
1450106,1077581,2021-05-13,Senate,"Senate 3rd Reading SB392 Archuleta et al",36,0,4,0,40
1450107,1030792,2021-03-17,Senate,"Do pass, but first be re-referred to the Committee on [Human Services] with the recommendation: To Consent Calendar",7,0,0,0,7
1450107,1035255,2021-03-23,Senate,"Do pass, but first be re-referred to the Committee on [Appropriations] with the recommendation: To Consent Calendar",5,0,0,0,5
1450107,1056422,2021-04-19,Senate,"Placed on suspense file",7,0,0,0,7
1450108,1028413,2021-03-15,Senate,"Do pass, but first be re-referred to the Committee on [Appropriations]",14,0,0,0,14
1450108,1044975,2021-04-05,Senate,"Senate 3rd Reading SB394 Hueso",38,0,2,0,40
1450109,1049010,2021-04-08,Senate,"Do pass as amended, but first amend, and re-refer to the Committee on [Health]",4,0,1,0,5
1450109,1065301,2021-04-28,Senate,"Do pass as amended, but first amend, and re-refer to the Committee on [Appropriations]",8,2,1,0,11
1450110,1054609,2021-04-15,Senate,"Do pass as amended, but first amend, and re-refer to the Committee on [Appropriations] with the recommendation: To Consent Calendar",9,0,0,0,9
1450110,1056343,2021-04-15,Senate,"Do pass, but first be re-referred to the Committee on [Appropriations] with the recommendation: To Consent Calendar",9,0,0,0,9
1450110,1077606,2021-05-13,Senate,"Consent Calendar SB396 Dahle",38,0,2,0,40
1450111,1053555,2021-04-13,Senate,"Do pass, but first be re-referred to the Committee on [Governmental Organization]",2,7,2,0,11
1450111,1053556,2021-04-13,Senate,"[First] hearing set for [04-14-2021]: Failed passage in Committee. Reconsideration granted",10,0,1,0,11
1450112,1048998,2021-04-08,Senate,"Do pass as amended, but first amend, and re-refer to the Committee on [Rules]",4,1,0,0,5
1450112,1056435,2021-04-19,Senate,"Do pass, but first be re-referred to the Committee on [Appropriations]",9,4,1,0,14
1450112,1068170,2021-05-03,Senate,"Placed on suspense file",6,0,1,0,7
1450113,1007231,2021-02-16,Senate,"Senate 3rd Reading SR9 Atkins",33,0,6,0,39
1451022,1035166,2021-03-23,Assembly,"Do pass. To Consent Calendar",11,0,0,0,11
1451022,1044991,2021-04-05,Assembly,"AB 611 Quirk-Silva Consent Calendar Second Day",74,0,4,0,78
1451025,1049869,2021-04-08,Assembly,"Do pass and be re-referred to the Committee on [Appropriations]",13,1,1,0,15
1451026,1054708,2021-04-15,Assembly,"Do pass and be re-referred to the Committee on [Appropriations]",5,2,0,0,7
1451027,1060931,2021-04-22,Assembly,"Do pass and be re-referred to the Committee on [Appropriations]",5,2,0,0,7
1451027,1073413,2021-05-05,Assembly,"Do pass",12,4,0,0,16
1451027,1075339,2021-05-10,Assembly,"AB 616 Stone Assembly Third Reading",50,17,11,0,78
1451029,1064013,2021-04-27,Assembly,"Do pass as amended, and be re-referred to the Committee on [Appropriations] with recommendation: To Consent Calendar",11,0,0,0,11
1451030,1046126,2021-04-06,Assembly,"Do pass as amended and be re-referred to the Committee on [Emergency Management]",15,0,0,0,15
1451030,1057669,2021-04-19,Assembly,"Do pass. To Consent Calendar",6,0,1,0,7
1451034,1054728,2021-04-15,Assembly,"Do pass and be re-referred to the Committee on [Appropriations] with recommendation: To Consent Calendar",11,0,0,0,11
1451034,1065267,2021-04-28,Assembly,"Do pass. To Consent Calendar",16,0,0,0,16
1451034,1074147,2021-05-06,Assembly,"AB 623 AGRI. Consent Calendar Second Day Regular Session",77,0,1,0,78
1451035,1065178,2021-04-27,Assembly,"Do pass and be re-referred to the Committee on [Appropriations]",8,0,0,0,8
1451036,1059199,2021-04-20,Assembly,"Do pass and be re-referred to the Committee on [Appropriations] with recommendation: To Consent Calendar",8,0,0,0,8
1451038,1035213,2021-03-23,Assembly,"Do pass and be re-referred to the Committee on [Appropriations] with recommendation: To Consent Calendar",11,0,0,0,11
1451038,1053521,2021-04-14,Assembly,"Do pass. To Consent Calendar",16,0,0,0,16
1451038,1060914,2021-04-22,Assembly,"AB 627 Waldron Consent Calendar Second Day Regular Session",77,0,2,0,79
1451039,1048983,2021-04-08,Assembly,"Do pass and be re-referred to the Committee on [Jobs, Economic Development, and the Economy]",7,0,0,0,7
1451039,1064124,2021-04-27,Assembly,"Do pass as amended and be re-referred to the Committee on [Appropriations]",6,0,1,0,7
1451040,1064151,2021-04-26,Assembly,"Do pass and be re-referred to the Committee on [Appropriations] with recommendation: To Consent Calendar",15,0,0,0,15
1451041,1064063,2021-04-27,Assembly,"Do pass as amended, and be re-referred to the Committee on [Appropriations] with recommendation: To Consent Calendar",6,0,1,0,7
1451042,1048879,2021-04-08,Assembly,"Do pass and be re-referred to the Committee on [Appropriations]",21,0,1,0,22
1451044,1035226,2021-03-23,Assembly,"Do pass. To Consent Calendar",11,0,0,0,11
1451044,1044983,2021-04-05,Assembly,"AB 633 Calderon Consent Calendar Second Day Regular Session",74,0,4,0,78
1451045,1054654,2021-04-15,Assembly,"Do pass as amended and be re-referred to the Committee on [Local Government]",6,2,0,0,8
1451045,1073342,2021-05-05,Assembly,"Do pass",6,2,0,0,8
1451046,1036493,2021-03-24,Assembly,"Do pass and be re-referred to the Committee on [Appropriations]",12,0,0,0,12
1451047,1046216,2021-04-06,Assembly,"Do pass",7,0,0,0,7
1451047,1053415,2021-04-12,Assembly,"AB 636 Maienschein Assembly Third Reading",73,0,5,0,78
1451048,1049021,2021-04-08,Assembly,"Do pass and be re-referred to the Committee on [Appropriations] with recommendation: To Consent Calendar",7,0,0,0,7
1451049,1046167,2021-04-06,Assembly,"Do pass and be re-referred to the Committee on [Appropriations]",15,0,0,0,15
1451049,1053423,2021-04-14,Assembly,"Do pass. To Consent Calendar",16,0,0,0,16
1451049,1060840,2021-04-22,Assembly,"AB 638 Quirk-Silva Consent Calendar Second Day Regular Session",77,0,2,0,79
1451051,1059279,2021-04-21,Assembly,"Do pass and be re-referred to the Committee on [Appropriations] with recommendation: To Consent Calendar",8,0,0,0,8
1451052,1059306,2021-04-21,Assembly,"Do pass as amended and be re-referred to the Committee on [Appropriations]",13,0,2,0,15
1451052,1076930,2021-05-12,Assembly,"Do pass",12,2,2,0,16
1451053,1036419,2021-03-24,Assembly,"Do pass and be re-referred to the Committee on [Appropriations]",9,0,2,0,11
1451054,1060874,2021-04-22,Assembly,"Do pass and be re-referred to the Committee on [Appropriations] with recommendation: To Consent Calendar",7,0,0,0,7
1451054,1073355,2021-05-05,Assembly,"Do pass. To Consent Calendar",16,0,0,0,16
1451054,1077562,2021-05-13,Assembly,"AB 643 Ramos Consent Calendar Second Day Regular Session",75,0,3,0,78
1451055,1047590,2021-04-06,Assembly,"Do pass and be re-referred to the Committee on [Appropriations]",8,0,0,0,8
1451055,1059224,2021-04-21,Assembly,"Do pass. To Consent Calendar",14,0,2,0,16
1451055,1066835,2021-04-29,Assembly,"AB 644 Waldron Consent Calendar Second Day Regular Session",77,0,1,0,78
1451056,1049877,2021-04-08,Assembly,"Do pass and be re-referred to the Committee on [Appropriations]",15,0,0,0,15
1451057,1035165,2021-03-23,Assembly,"Do pass and be re-referred to the Committee on [Appropriations]",17,0,2,0,19
1451061,1060947,2021-04-22,Assembly,"Do pass and be re-referred to the Committee on [Appropriations]",5,2,0,0,7
1451062,1057660,2021-04-20,Assembly,"Do pass as amended and be re-referred to the Committee on [Appropriations]",19,0,0,0,19
1451063,1047454,2021-04-07,Assembly,"Do pass",6,1,2,0,9
1451064,1047531,2021-04-06,Assembly,"Do pass and be re-referred to the Committee on [Appropriations] with recommendation: To Consent Calendar",8,0,0,0,8
1451065,1049008,2021-04-08,Assembly,"Do pass and be re-referred to the Committee on [Appropriations]",5,2,0,0,7
1451066,1047592,2021-04-06,Assembly,"Do pass and be re-referred to the Committee on [Appropriations]",5,3,0,0,8
1451068,1066709,2021-04-29,Assembly,"Do pass and be re-referred to the Committee on [Appropriations]",6,1,0,0,7
1451071,1054702,2021-04-14,Assembly,"Do pass and be re-referred to the Committee on [Transportation]",13,0,0,0,13
1451071,1064055,2021-04-26,Assembly,"Do pass and be re-referred to the Committee on [Appropriations] with recommendation: To Consent Calendar",15,0,0,0,15
1451072,1065182,2021-04-28,Assembly,"Do pass and be re-referred to the Committee on [Appropriations]",5,2,0,0,7
1451073,1057696,2021-04-20,Assembly,"Do pass and be re-referred to the Committee on [Judiciary]",14,0,1,0,15
1451073,1064059,2021-04-27,Assembly,"Do pass as amended, and be re-referred to the Committee on [Appropriations] with recommendation: To Consent Calendar",11,0,0,0,11
1451074,1054701,2021-04-15,Assembly,"Do pass and be re-referred to the Committee on [Appropriations] with recommendation: To Consent Calendar",12,0,0,0,12
1451074,1065285,2021-04-28,Assembly,"Do pass. To Consent Calendar",16,0,0,0,16
1451074,1074122,2021-05-06,Assembly,"AB 663 Chen Consent Calendar Second Day Regular Session",77,0,1,0,78
1451076,1059169,2021-04-21,Assembly,"Do pass and be re-referred to the Committee on [Appropriations] with recommendation: To Consent Calendar",8,0,0,0,8
1451077,1051986,2021-04-13,Assembly,"Do pass and be re-referred to the Committee on [Appropriations]",15,0,0,0,15
1451078,1047539,2021-04-06,Assembly,"Do pass and be re-referred to the Committee on [Appropriations] with recommendation: To Consent Calendar",8,0,0,0,8
1451080,1047443,2021-04-06,Assembly,"Do pass",6,2,0,0,8
1451081,1047482,2021-04-07,Assembly,"Do pass and be re-referred to the Committee on [Judiciary] with recommendation: To Consent Calendar",8,0,0,0,8
1451081,1057633,2021-04-20,Assembly,"Do pass and be re-referred to the Committee on [Appropriations] with recommendation: To Consent Calendar",10,0,1,0,11
1451082,1035185,2021-03-23,Assembly,"Do pass and be re-referred to the Committee on [Appropriations] with recommendation: To Consent Calendar",15,0,0,0,15
1451084,1047494,2021-04-06,Assembly,"Do pass and be re-referred to the Committee on [Appropriations] with recommendation: To Consent Calendar",8,0,0,0,8
1451084,1059281,2021-04-21,Assembly,"Do pass. To Consent Calendar",14,0,2,0,16
1451084,1066762,2021-04-29,Assembly,"AB 673 Salas Consent Calendar Second Day Regular Session",77,0,1,0,78
1451085,1047487,2021-04-07,Assembly,"Do pass and be re-referred to the Committee on [Judiciary] with recommendation: To Consent Calendar",8,0,0,0,8
1451085,1051961,2021-04-13,Assembly,"Do pass and be re-referred to the Committee on [Appropriations] with recommendation: To Consent Calendar",11,0,0,0,11
1451085,1065221,2021-04-28,Assembly,"Do pass. To Consent Calendar",16,0,0,0,16
1451085,1074107,2021-05-06,Assembly,"AB 674 Bennett Consent Calendar Second Day Regular Session",77,0,1,0,78
1451088,1059200,2021-04-21,Assembly,"Do pass and be re-referred to the Committee on [Appropriations]",7,1,0,0,8
1451090,1053475,2021-04-13,Assembly,"Do pass and be re-referred to the Committee on [Appropriations]",6,2,0,0,8
1451090,1065125,2021-04-28,Assembly,"Do pass",11,4,1,0,16
1451091,1048997,2021-04-08,Assembly,"Do pass and be re-referred to the Committee on [Natural Resources]",5,1,1,0,7
1451091,1065127,2021-04-28,Assembly,"Do pass as amended and be re-referred to the Committee on [Appropriations]",8,0,3,0,11
1451096,1051950,2021-04-13,Senate,"Do pass, but first be re-referred to the Committee on [Appropriations] with the recommendation: To Consent Calendar",16,0,1,0,17
1451096,1068202,2021-05-03,Senate,"Placed on suspense file",6,0,1,0,7
1451097,1030781,2021-03-17,Senate,"Do pass, but first be re-referred to the Committee on [Appropriations] with the recommendation: To Consent Calendar",7,0,0,0,7
1451097,1048938,2021-04-08,Senate,"Consent Calendar SB400",38,0,2,0,40
1451098,1033682,2021-03-22,Senate,"Do pass, but first be re-referred to the Committee on [Appropriations] with the recommendation: To Consent Calendar",14,0,0,0,14
1451098,1060927,2021-04-22,Senate,"Consent Calendar SB401",38,0,2,0,40
1451099,1047578,2021-04-07,Senate,"Do pass as amended, but first amend, and re-refer to the Committee on [Appropriations]",11,0,0,0,11
1451099,1068244,2021-05-03,Senate,"Placed on suspense file",6,0,1,0,7
1451100,1028402,2021-03-15,Senate,"Do pass, but first be re-referred to the Committee on [Governance and Finance]",5,1,1,0,7
1451100,1060876,2021-04-22,Senate,"Do pass as amended, but first amend, and re-refer to the Committee on [Appropriations]",3,1,1,0,5
1451103,1051924,2021-04-13,Senate,"Do pass, but first be re-referred to the Committee on [Appropriations]",7,0,2,0,9
1451103,1056367,2021-04-19,Senate,"Placed on suspense file",7,0,0,0,7
1451104,1033634,2021-03-22,Senate,"Do pass, but first be re-referred to the Committee on [Appropriations] with the recommendation: To Consent Calendar",14,0,0,0,14
1451104,1044968,2021-04-05,Senate,"Do pass",7,0,0,0,7
1451105,1074124,2021-05-06,Senate,"Do pass, but first be re-referred to the Committee on [Appropriations]",5,0,0,0,5
1451106,1023831,2021-03-08,Senate,"Do pass, but first be re-referred to the Committee on [Appropriations]",14,0,0,0,14
1451106,1045000,2021-04-05,Senate,"Senate 3rd Reading SB409 Caballero",38,0,2,0,40
1451107,1056393,2021-04-19,Senate,"Do pass, but first be re-referred to the Committee on [Appropriations]",4,1,0,0,5
1451108,1056437,2021-04-19,Senate,"Do pass, but first be re-referred to the Committee on [Appropriations]",5,0,0,0,5
1451108,1075267,2021-05-10,Senate,"Senate 3rd Reading SB411 Cortese",36,0,4,0,40
1451111,1033684,2021-03-22,Senate,"Do pass, but first be re-referred to the Committee on [Governance and Finance] with the recommendation: To Consent Calendar",14,0,0,0,14
1451111,1054627,2021-04-15,Senate,"Do pass, but first be re-referred to the Committee on [Appropriations]",5,0,0,0,5
1451111,1074163,2021-05-06,Senate,"Senate 3rd Reading SB414 Jones",37,0,3,0,40
1451113,1035163,2021-03-23,Senate,"Do pass, but first be re-referred to the Committee on [Education] with the recommendation: To Consent Calendar",5,0,0,0,5
1451113,1053525,2021-04-14,Senate,"Do pass as amended, but first amend, and re-refer to the Committee on [Appropriations] with the recommendation: To Consent Calendar",7,0,0,0,7
1451113,1068169,2021-05-03,Senate,"Placed on suspense file",6,0,1,0,7
1451114,1035155,2021-03-23,Senate,"Do pass, but first be re-referred to the Committee on [Appropriations]",14,0,1,0,15
1451114,1062772,2021-04-26,Senate,"Senate 3rd Reading SB417 Dodd",38,0,2,0,40
1451115,1064082,2021-04-27,Senate,"Do pass, but first be re-referred to the Committee on [Appropriations] with the recommendation: To Consent Calendar",9,0,0,0,9
1451115,1075395,2021-05-10,Senate,"Placed on suspense file",7,0,0,0,7
1451116,1051981,2021-04-13,Senate,"Do pass as amended, but first amend, and re-refer to the Committee on [Labor, Public Employment and Retirement ]",7,2,0,0,9
1451116,1064065,2021-04-26,Senate,"Do pass, but first be re-referred to the Committee on [Appropriations]",4,1,0,0,5
1451117,1038716,2021-03-22,Senate,"Do pass, but first be re-referred to the Committee on [Rules]",5,0,0,0,5
1451117,1064157,2021-04-27,Senate,"Do pass, but first be re-referred to the Committee on [Appropriations] with the recommendation: To Consent Calendar",5,0,0,0,5
1451117,1075393,2021-05-10,Senate,"Placed on suspense file",7,0,0,0,7
1451118,1063991,2021-04-27,Senate,"Do pass, but first be re-referred to the Committee on [Appropriations]",5,0,0,0,5
1451118,1075361,2021-05-10,Senate,"Placed on suspense file",7,0,0,0,7
1451119,1056429,2021-04-19,Senate,"Do pass, but first be re-referred to the Committee on [Appropriations]",4,1,0,0,5
1451119,1068224,2021-05-03,Senate,"Placed on suspense file",6,0,1,0,7
1451120,1050778,2021-04-12,Senate,"Do pass as amended, but first amend, and re-refer to the Committee on [Environmental Quality]",10,3,1,0,14
1451120,1062737,2021-04-26,Senate,"Do pass as amended, but first amend, and re-refer to the Committee on [Appropriations]",5,2,0,0,7
1451121,1074171,2021-05-06,Senate,"Do pass as amended, but first amend, and re-refer to the Committee on [Appropriations]",5,0,0,0,5
1451123,1028425,2021-03-15,Senate,"Do pass, but first be re-referred to the Committee on [Appropriations]",7,0,0,0,7
1451123,1033604,2021-03-22,Senate,"Placed on suspense file",7,0,0,0,7
1451124,1048941,2021-04-08,Senate,"Do pass as amended, but first amend, and re-refer to the Committee on [Public Safety]",5,0,0,0,5
1451124,1068214,2021-05-03,Senate,"Senate 3rd Reading SB427 Eggman",36,0,4,0,40
1451125,1059183,2021-04-21,Senate,"Do pass, but first be re-referred to the Committee on [Appropriations]",11,0,0,0,11
1451127,1025130,2021-03-09,Senate,"Do pass, but first be re-referred to the Committee on [Business, Professions and Economic Development]",14,0,0,0,14
1451127,1033656,2021-03-22,Senate,"Do pass, but first be re-referred to the Committee on [Appropriations]",12,0,2,0,14
1451127,1056351,2021-04-19,Senate,"Placed on suspense file",7,0,0,0,7
1451128,1037861,2021-03-25,Senate,"Do pass and be ordered to the Consent Calendar",5,0,0,0,5
1451128,1048977,2021-04-08,Senate,"Consent Calendar SB431 Rubio",38,0,2,0,40
1451129,1054699,2021-04-15,Senate,"Do pass, but first be re-referred to the Committee on [Judiciary] with the recommendation: To Consent Calendar",9,0,0,0,9
1451129,1072237,2021-05-04,Senate,"Do pass and be ordered to the Consent Calendar",11,0,0,0,11
1451129,1075335,2021-05-10,Senate,"Consent Calendar SB432",37,0,3,0,40
1451130,1064149,2021-04-27,Senate,"Do pass as amended, but first amend, and re-refer to the Committee on [Appropriations]",9,0,0,0,9
1451131,1018532,2021-03-01,Senate,"Senate 3rd Reading SR10 Pan",35,0,4,0,39
1453356,1036488,2021-03-24,Assembly,"Do pass. To Consent Calendar",8,0,0,0,8
1453356,1048915,2021-04-08,Assembly,"AB 687 Seyarto Consent Calendar Second Day Regular Session",74,0,4,0,78
1453358,1053460,2021-04-13,Assembly,"Do pass and be re-referred to the Committee on [Appropriations] with recommendation: To Consent Calendar",8,0,0,0,8
1453358,1073341,2021-05-05,Assembly,"Do pass. To Consent Calendar",16,0,0,0,16
1453358,1077598,2021-05-13,Assembly,"AB 689 Petrie-Norris Consent Calendar Second Day Regular Session",75,0,3,0,78
1453359,1046163,2021-04-06,Assembly,"Do pass and be re-referred to the Committee on [Appropriations] with recommendation: To Consent Calendar",18,0,1,0,19
1453359,1053424,2021-04-14,Assembly,"Do pass. To Consent Calendar",16,0,0,0,16
1453360,1057690,2021-04-20,Assembly,"Do pass and be re-referred to the Committee on [Appropriations]",19,0,0,0,19
1453360,1073414,2021-05-05,Assembly,"Do pass. To Consent Calendar",16,0,0,0,16
1453360,1077561,2021-05-13,Assembly,"AB 691 Chau Consent Calendar Second Day Regular Session",75,0,3,0,78
1453361,1049868,2021-04-08,Assembly,"Do pass and be re-referred to the Committee on [Appropriations] with recommendation: To Consent Calendar",15,0,0,0,15
1453363,1060918,2021-04-22,Assembly,"Do pass and be re-referred to the Committee on [Appropriations] with recommendation: To Consent Calendar",11,0,0,0,11
1453363,1073391,2021-05-05,Assembly,"Do pass. To Consent Calendar",16,0,0,0,16
1453363,1077544,2021-05-13,Assembly,"AB 694 P. & C.P. Consent Calendar Second Day Regular Session",75,0,3,0,78
1453364,1057687,2021-04-20,Assembly,"Do pass and be re-referred to the Committee on [Appropriations]",7,0,0,0,7
1453366,1036509,2021-03-24,Assembly,"Do pass and be re-referred to the Committee on [Appropriations]",8,2,1,0,11
1453366,1076935,2021-05-12,Assembly,"Do pass",13,1,2,0,16
1453367,1047575,2021-04-07,Assembly,"Do pass and be re-referred to the Committee on [Appropriations] with recommendation: To Consent Calendar",9,0,0,0,9
1453367,1053534,2021-04-14,Assembly,"Do pass. To Consent Calendar",16,0,0,0,16
1453367,1060949,2021-04-22,Assembly,"AB 698 E.S. & T.M. Consent Calendar Second Day Regular Session",77,0,2,0,79
1453368,1047478,2021-04-07,Assembly,"Do pass as amended and be re-referred to the Committee on [Natural Resources]",12,0,3,0,15
1453368,1065155,2021-04-28,Assembly,"Do pass as amended and be re-referred to the Committee on [Appropriations]",11,0,0,0,11
1453369,1065192,2021-04-27,Assembly,"Do pass as amended",8,0,0,0,8
1453370,1060847,2021-04-22,Assembly,"Do pass and be re-referred to the Committee on [Appropriations]",5,2,0,0,7
1453375,1077557,2021-05-13,Assembly,"Do pass",10,0,2,0,12
1453376,1059243,2021-04-21,Assembly,"Do pass and be re-referred to the Committee on [Appropriations]",8,0,1,0,9
1453379,1054603,2021-04-15,Assembly,"Do pass and be re-referred to the Committee on [Appropriations]",9,1,1,0,11
1453381,1073395,2021-05-05,Assembly,"Do pass as amended",8,0,0,0,8
1453382,1065164,2021-04-28,Assembly,"Do pass and be re-referred to the Committee on [Appropriations]",10,0,1,0,11
1453385,1035206,2021-03-23,Assembly,"Do pass as amended and be re-referred to the Committee on [Appropriations]",10,0,1,0,11
1453386,1053416,2021-04-13,Assembly,"Do pass and be re-referred to the Committee on [Appropriations]",6,2,0,0,8
1453387,1053452,2021-04-13,Assembly,"Do pass and be re-referred to the Committee on [Appropriations] with recommendation: To Consent Calendar",8,0,0,0,8
1453387,1065085,2021-04-28,Assembly,"Do pass. To Consent Calendar",16,0,0,0,16
1453387,1074110,2021-05-06,Assembly,"AB 718 Cunningham Consent Calendar Second Day Regular Session",77,0,1,0,78
1453388,1066796,2021-04-29,Assembly,"Do pass and be re-referred to the Committee on [Appropriations] with recommendation: To Consent Calendar",11,0,0,0,11
1453390,1054737,2021-04-15,Assembly,"Do pass as amended and be re-referred to the Committee on [Judiciary]",5,0,3,0,8
1453390,1064081,2021-04-27,Assembly,"Do pass as amended and be re-referred to the Committee on [Appropriations]",7,3,1,0,11
1453392,1035266,2021-03-23,Assembly,"Do pass and be re-referred to the Committee on [Appropriations] with recommendation: To Consent Calendar",17,0,2,0,19
1453392,1053471,2021-04-14,Assembly,"Do pass. To Consent Calendar",16,0,0,0,16
1453395,1036496,2021-03-24,Assembly,"Do pass",8,0,0,0,8
1453395,1048948,2021-04-08,Assembly,"AB 726 Eduardo Garcia Assembly Third Reading",74,0,4,0,78
1453397,1054641,2021-04-15,Assembly,"Do pass and be re-referred to the Committee on [Appropriations]",7,0,0,0,7
1453399,1050810,2021-04-12,Assembly,"Do pass and be re-referred to the Committee on [Higher Education]",7,0,0,0,7
1453399,1060990,2021-04-22,Assembly,"Do pass and be re-referred to the Committee on [Appropriations]",12,0,0,0,12
1453399,1073381,2021-05-05,Assembly,"Do pass",16,0,0,0,16
1453400,1053531,2021-04-13,Assembly,"Do pass and be re-referred to the Committee on [Appropriations]",7,0,1,0,8
1453411,1035265,2021-03-22,Assembly,"Do pass and be re-referred to the Committee on [Appropriations]",10,0,1,0,11
1453411,1059236,2021-04-21,Assembly,"Do pass. To Consent Calendar",14,0,2,0,16
1453411,1066745,2021-04-29,Assembly,"AB 742 Calderon Consent Calendar Second Day Regular Session",77,0,1,0,78
1453413,1052015,2021-04-12,Assembly,"Do pass and be re-referred to the Committee on [Appropriations] with recommendation: To Consent Calendar",15,0,0,0,15
1453414,1064042,2021-04-26,Assembly,"Do pass and be re-referred to the Committee on [Appropriations] with recommendation: To Consent Calendar",15,0,0,0,15
1453415,1072287,2021-05-04,Assembly,"Do pass as amended",9,1,1,0,11
1453418,1057731,2021-04-20,Assembly,"Do pass and be re-referred to the Committee on [Appropriations]",15,0,0,0,15
1453418,1065283,2021-04-28,Assembly,"Do pass. To Consent Calendar",16,0,0,0,16
1453418,1074187,2021-05-06,Assembly,"AB 749 Nazarian Consent Calendar Second Day Regular Session",77,0,1,0,78
1453419,1059254,2021-04-20,Assembly,"Do pass and be re-referred to the Committee on [Appropriations] with recommendation: To Consent Calendar",8,0,0,0,8
1453420,1057647,2021-04-20,Assembly,"Do pass and be re-referred to the Committee on [Appropriations]",15,0,0,0,15
1453420,1065083,2021-04-28,Assembly,"Do pass",16,0,0,0,16
1453420,1068203,2021-05-03,Assembly,"AB 751 Irwin Assembly Third Reading",75,0,3,0,78
1453421,1052029,2021-04-13,Assembly,"Do pass as amended and be re-referred to the Committee on [Appropriations]",13,0,2,0,15
1453422,1059218,2021-04-21,Assembly,"Do pass and be re-referred to the Committee on [Housing and Community Development]",7,1,1,0,9
1453422,1067603,2021-04-29,Assembly,"Do pass and be re-referred to the Committee on [Appropriations]",6,2,0,0,8
1453423,1064098,2021-04-26,Assembly,"Do pass and be re-referred to the Committee on [Appropriations]",9,4,2,0,15
1453425,1060962,2021-04-22,Assembly,"Do pass and be re-referred to the Committee on [Banking and Finance]",9,2,1,0,12
1453427,1065173,2021-04-28,Assembly,"Do pass as amended and be re-referred to the Committee on [Appropriations]",7,0,1,0,8
1453428,1066774,2021-04-29,Assembly,"Do pass and be re-referred to the Committee on [Appropriations]",5,1,1,0,7
1453429,1059182,2021-04-20,Assembly,"Do pass and be re-referred to the Committee on [Appropriations] with recommendation: To Consent Calendar",8,0,0,0,8
1453430,1054724,2021-04-15,Assembly,"Do pass. To Consent Calendar",7,0,0,0,7
1453430,1060835,2021-04-22,Assembly,"AB 761 Chen Consent Calendar Second Day Regular Session",77,0,2,0,79
1453431,1047587,2021-04-07,Assembly,"Do pass and be re-referred to the Committee on [Education]",6,0,3,0,9
1453431,1065248,2021-04-28,Assembly,"Do pass as amended and be re-referred to the Committee on [Appropriations]",5,1,1,0,7
1453433,1053482,2021-04-13,Assembly,"Do pass and be re-referred to the Committee on [Appropriations] with recommendation: To Consent Calendar",8,0,0,0,8
1453433,1065123,2021-04-28,Assembly,"Do pass",16,0,0,0,16
1453433,1074186,2021-05-06,Assembly,"AB 764 Cervantes Assembly Third Reading",76,0,2,0,78
1453440,1035248,2021-03-22,Assembly,"Do pass and be re-referred to the Committee on [Appropriations] with recommendation: To Consent Calendar",15,0,0,0,15
1453442,1073369,2021-05-05,Assembly,"Do pass",8,0,0,0,8
1453442,1077582,2021-05-13,Assembly,"AB 773 Nazarian Assembly Third Reading",72,0,6,0,78
1453444,1048967,2021-04-08,Assembly,"Do pass as amended and be re-referred to the Committee on [Appropriations]",12,0,0,0,12
1453446,1065222,2021-04-28,Assembly,"Do pass as amended and be re-referred to the Committee on [Appropriations]",7,0,0,0,7
1453447,1053511,2021-04-14,Assembly,"Do pass and be re-referred to the Committee on [Agriculture]",7,0,0,0,7
1453447,1066697,2021-04-29,Assembly,"Do pass as amended and be re-referred to the Committee on [Appropriations]",11,0,0,0,11
1453448,1047559,2021-04-06,Assembly,"Do pass",6,1,1,0,8
1453448,1056494,2021-04-19,Assembly,"AB 779 Bigelow Assembly Third Reading",70,3,6,0,79
1453450,1064096,2021-04-26,Assembly,"Do pass and be re-referred to the Committee on [Appropriations] with recommendation: To Consent Calendar",15,0,0,0,15
1453452,1060845,2021-04-22,Assembly,"Do pass and be re-referred to the Committee on [Appropriations]",7,0,0,0,7
1453453,1036534,2021-03-24,Assembly,"Do pass and be re-referred to the Committee on [Appropriations]",8,0,0,0,8
1453453,1053535,2021-04-14,Assembly,"Do pass. To Consent Calendar",16,0,0,0,16
1453453,1060936,2021-04-22,Assembly,"AB 784 Quirk Consent Calendar Second Day Regular Session",77,0,2,0,79
1453456,1054744,2021-04-15,Assembly,"Do pass as amended and be re-referred to the Committee on [Local Government]",8,0,0,0,8
1453456,1065121,2021-04-28,Assembly,"Do pass as amended and be re-referred to the Committee on [Appropriations]",8,0,0,0,8
1453457,1047419,2021-04-07,Assembly,"Do pass and be re-referred to the Committee on [Judiciary] with recommendation: To Consent Calendar",8,0,0,0,8
1453457,1052026,2021-04-13,Assembly,"Do pass. To Consent Calendar",11,0,0,0,11
1453457,1056495,2021-04-19,Assembly,"AB 788 Calderon Consent Calendar Second Day Regular Session",78,0,1,0,79
1453458,1057666,2021-04-20,Assembly,"Do pass and be re-referred to the Committee on [Appropriations] with recommendation: To Consent Calendar",15,0,0,0,15
1453459,1048936,2021-04-08,Assembly,"Do pass and be re-referred to the Committee on [Judiciary] with recommendation: To Consent Calendar",11,0,0,0,11
1453459,1072248,2021-05-04,Assembly,"Do pass. To Consent Calendar",11,0,0,0,11
1453459,1075328,2021-05-10,Assembly,"AB 790 Quirk-Silva Consent Calendar Second Day Regular Session",74,0,4,0,78
1453461,1065279,2021-04-28,Assembly,"Do pass and be re-referred to the Committee on [Appropriations]",11,0,0,0,11
1453463,1060957,2021-04-22,Assembly,"Do pass and be re-referred to the Committee on [Transportation]",5,2,0,0,7
1453463,1064161,2021-04-26,Assembly,"Do pass as amended and be re-referred to the Committee on [Appropriations]",11,4,0,0,15
1453465,1054753,2021-04-15,Assembly,"Do pass and be re-referred to the Committee on [Transportation]",5,1,1,0,7
1453465,1064000,2021-04-26,Assembly,"Do pass and be re-referred to the Committee on [Appropriations]",10,4,1,0,15
1453467,1056417,2021-04-19,Assembly,"Do pass and be re-referred to the Committee on [Appropriations] with recommendation: To Consent Calendar",15,0,0,0,15
1453467,1073383,2021-05-05,Assembly,"Do pass. To Consent Calendar",16,0,0,0,16
1453467,1077535,2021-05-13,Assembly,"AB 798 Ramos Consent Calendar Second Day Regular Session",75,0,3,0,78
1453472,1054665,2021-04-15,Assembly,"Do pass as amended and be re-referred to the Committee on [Local Government]",8,0,0,0,8
1453472,1065304,2021-04-28,Assembly,"Do pass and be re-referred to the Committee on [Appropriations]",8,0,0,0,8
1453472,1076933,2021-05-12,Assembly,"Do pass. To Consent Calendar",16,0,0,0,16
1453473,1049889,2021-04-08,Assembly,"Do pass and be re-referred to the Committee on [Appropriations]",11,0,4,0,15
1453473,1059207,2021-04-21,Assembly,"Do pass",12,2,2,0,16
1453473,1066815,2021-04-29,Assembly,"AB 804 Megan Dahle Assembly Third Reading",58,11,9,0,78
1453474,1044949,2021-04-05,Assembly,"Do pass and be re-referred to the Committee on [Appropriations]",7,0,0,0,7
1453476,1064060,2021-04-26,Assembly,"Do pass and be re-referred to the Committee on [Appropriations] with recommendation: To Consent Calendar",15,0,0,0,15
1453477,1059168,2021-04-21,Assembly,"Do pass and be re-referred to the Committee on [Health]",8,0,0,0,8
1453477,1064053,2021-04-27,Assembly,"Do pass and be re-referred to the Committee on [Appropriations]",15,0,0,0,15
1453478,1049018,2021-04-08,Assembly,"Do pass and be re-referred to the Committee on [Accountability and Administrative Review] with recommendation: To Consent Calendar",11,0,0,0,11
1453478,1065289,2021-04-28,Assembly,"Do pass as amended and be re-referred to the Committee on [Appropriations]",7,0,0,0,7
1453480,1054653,2021-04-14,Assembly,"Do pass and be re-referred to the Committee on [Transportation]",8,0,0,0,8
1453480,1064018,2021-04-26,Assembly,"Do pass and be re-referred to the Committee on [Appropriations] with recommendation: To Consent Calendar",15,0,0,0,15
1453482,1059223,2021-04-21,Assembly,"Do pass and be re-referred to the Committee on [Appropriations] with recommendation: To Consent Calendar",8,0,0,0,8
1453483,1049032,2021-04-08,Assembly,"Do pass and be re-referred to the Committee on [Judiciary]",10,1,0,0,11
1453483,1057740,2021-04-20,Assembly,"Do pass as amended and be re-referred to the Committee on [Appropriations]",8,2,1,0,11
1453484,1036456,2021-03-24,Assembly,"Do pass and be re-referred to the Committee on [Appropriations]",7,0,0,0,7
1453485,1067605,2021-04-29,Assembly,"Do pass as amended and be re-referred to the Committee on [Appropriations]",5,1,2,0,8
1453486,1049886,2021-04-08,Assembly,"Do pass and be re-referred to the Committee on [Appropriations] with recommendation: To Consent Calendar",15,0,0,0,15
1453487,1047481,2021-04-07,Assembly,"Do pass and be re-referred to the Committee on [Judiciary] with recommendation: To Consent Calendar",9,0,0,0,9
1453487,1051917,2021-04-13,Assembly,"Do pass and be re-referred to the Committee on [Appropriations] with recommendation: To Consent Calendar",11,0,0,0,11
1453487,1073350,2021-05-05,Assembly,"Do pass. To Consent Calendar",16,0,0,0,16
1453487,1077545,2021-05-13,Assembly,"AB 818 Bloom Consent Calendar Second Day Regular Session",75,0,3,0,78
1453488,1036476,2021-03-24,Assembly,"Do pass as amended and be re-referred to the Committee on [Appropriations]",11,0,0,0,11
1453488,1053550,2021-04-14,Assembly,"Do pass. To Consent Calendar",16,0,0,0,16
1453488,1060827,2021-04-22,Assembly,"AB 819 Levine Consent Calendar Second Day Regular Session",77,0,2,0,79
1453491,1064099,2021-04-27,Assembly,"Do pass and be re-referred to the Committee on [Appropriations]",15,0,0,0,15
1453493,1036431,2021-03-24,Assembly,"Do pass as amended and be re-referred to the Committee on [Appropriations]",7,0,0,0,7
1453493,1065317,2021-04-28,Assembly,"Do pass. To Consent Calendar",16,0,0,0,16
1453493,1074189,2021-05-06,Assembly,"AB 824 Bennett Consent Calendar Second Day Regular Session",77,0,1,0,78
1453494,1048995,2021-04-08,Assembly,"Do pass and be re-referred to the Committee on [Appropriations]",11,0,0,0,11
1453495,1053522,2021-04-14,Assembly,"Do pass as amended and be re-referred to the Committee on [Appropriations]",9,2,0,0,11
1453497,1026090,2021-03-10,Senate,"Do pass, but first be re-referred to the Committee on [Human Services] with the recommendation: To Consent Calendar",11,0,0,0,11
1453497,1035182,2021-03-23,Senate,"Do pass, but first be re-referred to the Committee on [Appropriations]",5,0,0,0,5
1453499,1026111,2021-03-10,Senate,"Do pass and be ordered to the Consent Calendar",7,0,0,0,7
1453499,1033616,2021-03-22,Senate,"Consent Calendar SB436",37,0,3,0,40
1453500,1056383,2021-04-19,Senate,"Do pass as amended, but first amend, and re-refer to the Committee on [Transportation]",11,3,0,0,14
1453500,1075305,2021-05-10,Senate,"Do pass",5,2,0,0,7
1453500,1077524,2021-05-13,Senate,"Senate 3rd Reading SB437 Wieckowski",29,9,2,0,40
1453501,1037846,2021-03-25,Senate,"Do pass, but first be re-referred to the Committee on [Appropriations]",5,0,0,0,5
1453501,1056374,2021-04-19,Senate,"Placed on suspense file",7,0,0,0,7
1453504,1047453,2021-04-07,Senate,"Do pass, but first be re-referred to the Committee on [Appropriations] with the recommendation: To Consent Calendar",11,0,0,0,11
1453504,1075238,2021-05-10,Senate,"Consent Calendar SB441",37,0,3,0,40
1453505,1050796,2021-04-12,Senate,"Do pass as amended, but first amend, and re-refer to the Committee on [Education]",5,0,0,0,5
1453505,1065156,2021-04-28,Senate,"Do pass",6,0,1,0,7
1453505,1074142,2021-05-06,Senate,"Senate 3rd Reading SB442 Newman",34,0,6,0,40
1453506,1062732,2021-04-26,Senate,"Do pass as amended, but first amend, and re-refer to the Committee on [Appropriations]",4,1,0,0,5
1453506,1077621,2021-05-13,Senate,"Senate 3rd Reading SB443 Hertzberg",31,6,3,0,40
1453507,1037872,2021-03-25,Senate,"Do pass, but first be re-referred to the Committee on [Appropriations] with the recommendation: To Consent Calendar",5,0,0,0,5
1453507,1056344,2021-04-19,Senate,"Placed on suspense file",7,0,0,0,7
1453508,1064147,2021-04-27,Senate,"Do pass, but first be re-referred to the Committee on [Appropriations]",1,3,1,0,5
1453508,1064148,2021-04-27,Senate,"[First] hearing set for [04-27-2021]: Failed passage in Committee. Reconsideration granted",5,0,0,0,5
1453509,1046105,2021-04-06,Senate,"Do pass, but first be re-referred to the Committee on [Appropriations] with the recommendation: To Consent Calendar",5,0,0,0,5
1453509,1056330,2021-04-19,Senate,"Placed on suspense file",7,0,0,0,7
1453510,1059284,2021-04-20,Senate,"Do pass as amended",9,2,0,0,11
1453510,1066801,2021-04-29,Senate,"Senate 3rd Reading SB447 Laird",24,10,6,0,40
1453512,1059151,2021-04-21,Senate,"Do pass as amended, but first amend, and re-refer to the Committee on [Environmental Quality]",6,2,1,0,9
1453512,1066740,2021-04-29,Senate,"Do pass, but first be re-referred to the Committee on [Appropriations]",5,2,0,0,7
1453513,1035222,2021-03-23,Senate,"Do pass, but first be re-referred to the Committee on [Appropriations] with the recommendation: To Consent Calendar",14,0,1,0,15
1453513,1045024,2021-04-05,Senate,"Placed on suspense file",7,0,0,0,7
1453514,1062760,2021-04-26,Senate,"Do pass, but first be re-referred to the Committee on [Appropriations]",7,0,0,0,7
1453514,1075247,2021-05-10,Senate,"Placed on suspense file",7,0,0,0,7
1453515,1035192,2021-03-23,Senate,"Do pass as amended, but first amend, and re-refer to the Committee on [Judiciary]",9,3,3,0,15
1453515,1065316,2021-04-27,Senate,"Do pass, but first be re-referred to the Committee on [Appropriations]",9,1,1,0,11
1453515,1075262,2021-05-10,Senate,"Placed on suspense file",7,0,0,0,7
1453516,1031910,2021-03-18,Senate,"Do pass, but first be re-referred to the Committee on [Education]",5,0,0,0,5
1453516,1047532,2021-04-07,Senate,"Do pass, but first be re-referred to the Committee on [Appropriations] with the recommendation: To Consent Calendar",7,0,0,0,7
1453516,1056333,2021-04-19,Senate,"Placed on suspense file",7,0,0,0,7
1453517,1047491,2021-04-06,Senate,"Do pass and be ordered to the Consent Calendar",11,0,0,0,11
1453517,1060829,2021-04-22,Senate,"Consent Calendar SB454",38,0,2,0,40
1453518,1036512,2021-03-24,Senate,"Do pass, but first be re-referred to the Committee on [Appropriations]",11,0,0,0,11
1453518,1074181,2021-05-06,Senate,"Senate 3rd Reading SB455 Leyva",36,0,4,0,40
1453519,1064090,2021-04-27,Senate,"Do pass, but first be re-referred to the Committee on [Appropriations]",9,0,0,0,9
1453519,1075362,2021-05-10,Senate,"Placed on suspense file",7,0,0,0,7
1453520,1056334,2021-04-19,Senate,"Do pass, but first be re-referred to the Committee on [Appropriations]",4,1,0,0,5
1453520,1068216,2021-05-03,Senate,"Placed on suspense file",6,0,1,0,7
1453521,1027164,2021-03-11,Senate,"Do pass and be ordered to the Consent Calendar",5,0,0,0,5
1453521,1033619,2021-03-22,Senate,"Consent Calendar SB458",37,0,3,0,40
1453522,1062794,2021-04-26,Senate,"Do pass as amended, but first amend, and re-refer to the Committee on [Appropriations]",4,0,1,0,5
1453522,1075348,2021-05-10,Senate,"Placed on suspense file",7,0,0,0,7
1453523,1035257,2021-03-23,Senate,"Do pass, but first be re-referred to the Committee on [Health] with the recommendation: To Consent Calendar",5,0,0,0,5
1453523,1053458,2021-04-14,Senate,"Do pass, but first be re-referred to the Committee on [Appropriations] with the recommendation: To Consent Calendar",11,0,0,0,11
1453523,1068271,2021-05-03,Senate,"Placed on suspense file",6,0,1,0,7
1453524,1035156,2021-03-23,Senate,"Do pass, but first be re-referred to the Committee on [Appropriations]",9,1,1,0,11
1453524,1044997,2021-04-05,Senate,"Placed on suspense file",7,0,0,0,7
1453525,1025129,2021-03-09,Senate,"Do pass, but first be re-referred to the Committee on [Appropriations]",14,0,0,0,14
1453525,1033649,2021-03-22,Senate,"Placed on suspense file",7,0,0,0,7
1453526,1054742,2021-04-15,Senate,"Do pass and be ordered to the Consent Calendar",9,0,0,0,9
1453526,1060963,2021-04-22,Senate,"Consent Calendar SB463",38,0,2,0,40
1453527,1035244,2021-03-23,Senate,"Do pass, but first be re-referred to the Committee on [Appropriations]",4,1,0,0,5
1453527,1068223,2021-05-03,Senate,"Placed on suspense file",6,0,1,0,7
1453528,1059246,2021-04-21,Senate,"Do pass as amended, but first amend, and re-refer to the Committee on [Appropriations]",11,0,0,0,11
1453528,1075394,2021-05-10,Senate,"Placed on suspense file",7,0,0,0,7
1453529,1074151,2021-05-06,Senate,"Do pass as amended",5,0,0,0,5
1453530,1051940,2021-04-13,Senate,"Do pass as amended, but first amend, and re-refer to the Committee on [Environmental Quality]",4,3,2,0,9
1453530,1051941,2021-04-13,Senate,"[First] hearing set for [04-13-2021]: Failed passage in Committee. Reconsideration granted",9,0,0,0,9
1453531,1057698,2021-04-20,Senate,"Do pass, but first be re-referred to the Committee on [Appropriations] with the recommendation: To Consent Calendar",15,0,0,0,15
1453531,1075381,2021-05-10,Senate,"Consent Calendar SB468",37,0,3,0,40
1453532,1023841,2021-03-08,Senate,"Senate 3rd Reading SR11 Leyva et al",35,0,4,0,39
1453533,1029570,2021-03-16,Senate,"Be adopted. Ordered to third reading",11,0,0,0,11
1453533,1031913,2021-03-18,Senate,"Senate 3rd Reading SR12 Min et al",36,0,4,0,40
1454830,1047490,2021-04-07,Assembly,"Do pass and be re-referred to the Committee on [Judiciary]",7,0,1,0,8
1454830,1051887,2021-04-13,Assembly,"Do pass and be re-referred to the Committee on [Appropriations]",9,0,2,0,11
1454831,1065213,2021-04-27,Assembly,"Do pass and be re-referred to the Committee on [Appropriations] with recommendation: To Consent Calendar",19,0,0,0,19
1454831,1073444,2021-05-05,Assembly,"Do pass. To Consent Calendar",16,0,0,0,16
1454832,1035179,2021-03-23,Assembly,"Do pass and be re-referred to the Committee on [Appropriations] with recommendation: To Consent Calendar",15,0,0,0,15
1454832,1053456,2021-04-14,Assembly,"Do pass. To Consent Calendar",16,0,0,0,16
1454832,1060866,2021-04-22,Assembly,"AB 831 HEALTH Consent Calendar Second Day Regular Session",77,0,2,0,79
1454833,1054704,2021-04-15,Assembly,"Do pass and be re-referred to the Committee on [Local Government]",8,0,0,0,8
1454833,1073353,2021-05-05,Assembly,"Do pass as amended",8,0,0,0,8
1454836,1052001,2021-04-13,Assembly,"Do pass and be re-referred to the Committee on [Appropriations]",13,0,2,0,15
1454838,1046159,2021-04-05,Assembly,"Do pass and be re-referred to the Committee on [Appropriations]",9,0,2,0,11
1454839,1054670,2021-04-15,Assembly,"Do pass and be re-referred to the Committee on [Appropriations]",6,2,0,0,8
1454839,1065227,2021-04-28,Assembly,"Do pass",12,4,0,0,16
1454839,1075273,2021-05-10,Assembly,"AB 838 Friedman Assembly Third Reading",45,18,15,0,78
1454840,1048885,2021-04-07,Assembly,"Do pass and be re-referred to the Committee on [Appropriations]",7,0,0,0,7
1454842,1047433,2021-04-07,Assembly,"Do pass and be re-referred to the Committee on [Judiciary] with recommendation: To Consent Calendar",8,0,0,0,8
1454842,1051880,2021-04-13,Assembly,"Do pass. To Consent Calendar",11,0,0,0,11
1454842,1056496,2021-04-19,Assembly,"AB 841 Cunningham Consent Calendar Second Day Regular Session",78,0,1,0,79
1454844,1047428,2021-04-07,Assembly,"Do pass as amended and be re-referred to the Committee on [Appropriations]",15,0,0,0,15
1454845,1065181,2021-04-27,Assembly,"Do pass as amended. To Consent Calendar",6,0,1,0,7
1454845,1075279,2021-05-10,Assembly,"AB 844 Grayson Consent Calendar Second Day",74,0,4,0,78
1454846,1054685,2021-04-15,Assembly,"Do pass and be re-referred to the Committee on [Appropriations]",6,1,0,0,7
1454846,1065122,2021-04-28,Assembly,"Do pass",14,0,2,0,16
1454846,1074113,2021-05-06,Assembly,"AB 845 Rodriguez Assembly Third Reading",74,0,4,0,78
1454847,1048976,2021-04-08,Assembly,"Do pass and be re-referred to the Committee on [Appropriations]",9,3,0,0,12
1454847,1059197,2021-04-21,Assembly,"Do pass",10,4,2,0,16
1454848,1051905,2021-04-13,Assembly,"Do pass and be re-referred to the Committee on [Appropriations]",17,0,2,0,19
1454849,1035263,2021-03-23,Assembly,"Do pass and be re-referred to the Committee on [Appropriations] with recommendation: To Consent Calendar",15,0,0,0,15
1454850,1051954,2021-04-13,Assembly,"Do pass",8,3,0,0,11
1454850,1062743,2021-04-26,Assembly,"AB 849 Reyes Assembly Third Reading",51,14,13,0,78
1454851,1049870,2021-04-08,Assembly,"Do pass and be re-referred to the Committee on [Local Government]",15,0,0,0,15
1454851,1065152,2021-04-28,Assembly,"Do pass and be re-referred to the Committee on [Appropriations] with recommendation: To Consent Calendar",8,0,0,0,8
1454853,1057653,2021-04-20,Assembly,"Do pass as amended and be re-referred to the Committee on [Appropriations]",17,0,2,0,19
1454853,1073420,2021-05-05,Assembly,"Do pass",16,0,0,0,16
1454856,1035252,2021-03-23,Assembly,"Do pass and be re-referred to the Committee on [Appropriations]",10,0,1,0,11
1454856,1053472,2021-04-14,Assembly,"Do pass",16,0,0,0,16
1454856,1062788,2021-04-26,Assembly,"AB 855 Ramos Assembly Third Reading",75,0,3,0,78
1454857,1036451,2021-03-24,Assembly,"Do pass as amended, and be re-referred to the Committee on [Appropriations] with recommendation: To Consent Calendar",7,0,0,0,7
1454857,1053433,2021-04-14,Assembly,"Do pass. To Consent Calendar",16,0,0,0,16
1454857,1060883,2021-04-22,Assembly,"AB 856 Maienschein Consent Calendar Second Day Regular Session",77,0,2,0,79
1454858,1048914,2021-04-08,Assembly,"Do pass and be re-referred to the Committee on [Appropriations]",5,2,0,0,7
1454858,1059315,2021-04-21,Assembly,"Do pass",9,5,2,0,16
1454858,1074157,2021-05-06,Assembly,"AB 857 Kalra Assembly Third Reading",43,21,14,0,78
1454859,1048958,2021-04-08,Assembly,"Do pass and be re-referred to the Committee on [Health]",6,1,0,0,7
1454859,1064066,2021-04-27,Assembly,"Do pass as amended, and be re-referred to the Committee on [Appropriations] with recommendation: To Consent Calendar",12,1,2,0,15
1454859,1065084,2021-04-27,Assembly,"Do pass as amended and be re-referred to the Committee on [Appropriations]",12,1,2,0,15
1454860,1048946,2021-04-08,Assembly,"Do pass and be re-referred to the Committee on [Appropriations]",8,0,3,0,11
1454862,1068278,2021-05-03,Assembly,"Do pass as amended",6,2,0,0,8
1454862,1075351,2021-05-10,Assembly,"AB 861 Bennett Assembly Third Reading",41,20,17,0,78
1454864,1051971,2021-04-12,Assembly,"Do pass and be re-referred to the Committee on [Appropriations]",15,0,0,0,15
1454866,1047427,2021-04-07,Assembly,"Do pass and be re-referred to the Committee on [Education] with recommendation: To Consent Calendar",8,0,0,0,8
1454866,1065089,2021-04-28,Assembly,"Do pass and be re-referred to the Committee on [Appropriations]",7,0,0,0,7
1454867,1054674,2021-04-15,Assembly,"Do pass and be re-referred to the Committee on [Appropriations]",11,0,0,0,11
1454869,1059195,2021-04-21,Assembly,"Do pass and be re-referred to the Committee on [Business and Professions]",7,0,1,0,8
1454869,1063995,2021-04-27,Assembly,"Do pass and be re-referred to the Committee on [Appropriations] with recommendation: To Consent Calendar",19,0,0,0,19
1454870,1054746,2021-04-15,Assembly,"Do pass and be re-referred to the Committee on [Appropriations]",12,0,0,0,12
1454870,1065143,2021-04-28,Assembly,"Do pass. To Consent Calendar",16,0,0,0,16
1454870,1074158,2021-05-06,Assembly,"AB 869 Bloom Consent Calendar Second Day Regular Session",77,0,1,0,78
1454873,1066694,2021-04-29,Assembly,"Do pass and be re-referred to the Committee on [Appropriations]",13,0,0,0,13
1454874,1059211,2021-04-21,Assembly,"Do pass and be re-referred to the Committee on [Appropriations] with recommendation: To Consent Calendar",8,0,0,0,8
1454874,1076934,2021-05-12,Assembly,"Do pass. To Consent Calendar",16,0,0,0,16
1454875,1066730,2021-04-29,Assembly,"Do pass and be re-referred to the Committee on [Appropriations]",12,0,0,0,12
1454876,1064166,2021-04-27,Assembly,"Do pass and be re-referred to the Committee on [Appropriations]",14,0,1,0,15
1454877,1053419,2021-04-13,Assembly,"Do pass and be re-referred to the Committee on [Appropriations]",6,2,0,0,8
1454879,1049874,2021-04-08,Assembly,"Do pass and be re-referred to the Committee on [Appropriations] with recommendation: To Consent Calendar",15,0,0,0,15
1454880,1046118,2021-04-05,Assembly,"Do pass as amended and be re-referred to the Committee on [Appropriations]",10,0,1,0,11
1454881,1054712,2021-04-15,Assembly,"Do pass and be re-referred to the Committee on [Appropriations]",8,0,0,0,8
1454882,1036455,2021-03-24,Assembly,"Do pass and be re-referred to the Committee on [Appropriations]",11,0,0,0,11
1454882,1076926,2021-05-12,Assembly,"Do pass. To Consent Calendar",16,0,0,0,16
1454883,1046203,2021-04-06,Assembly,"Do pass as amended and be re-referred to the Committee on [Appropriations]",14,0,1,0,15
1454884,1046221,2021-04-06,Assembly,"Do pass as amended and be re-referred to the Committee on [Education]",15,0,0,0,15
1454884,1065175,2021-04-28,Assembly,"Do pass and be re-referred to the Committee on [Appropriations] with recommendation: To Consent Calendar",7,0,0,0,7
1454885,1053432,2021-04-14,Assembly,"Do pass and be re-referred to the Committee on [Governmental Organization]",7,0,0,0,7
1454885,1060953,2021-04-22,Assembly,"Do pass and be re-referred to the Committee on [Appropriations]",20,0,2,0,22
1454887,1065170,2021-04-27,Assembly,"Do pass as amended, and be re-referred to the Committee on [Appropriations] with recommendation: To Consent Calendar",8,0,0,0,8
1454888,1035176,2021-03-23,Assembly,"Do pass and be re-referred to the Committee on [Appropriations]",11,0,0,0,11
1454889,1066679,2021-04-29,Assembly,"Do pass and be re-referred to the Committee on [Appropriations]",10,0,1,0,11
1454890,1059245,2021-04-21,Assembly,"Do pass and be re-referred to the Committee on [Appropriations]",6,2,0,0,8
1454890,1073354,2021-05-05,Assembly,"Do pass",12,4,0,0,16
1454891,1066759,2021-04-29,Assembly,"Do pass and be re-referred to the Committee on [Appropriations]",5,1,1,0,7
1454892,1035160,2021-03-23,Assembly,"Do pass. To Consent Calendar",11,0,0,0,11
1454892,1045011,2021-04-05,Assembly,"AB 891 Cunningham Consent Calendar Second Day Regular Session",74,0,4,0,78
1454893,1053439,2021-04-13,Assembly,"Do pass and be re-referred to the Committee on [Appropriations]",3,4,1,0,8
1454897,1036423,2021-03-24,Assembly,"Do pass and be re-referred to the Committee on [Appropriations]",8,0,3,0,11
1454898,1053538,2021-04-14,Assembly,"Do pass as amended and be re-referred to the Committee on [Appropriations]",8,1,2,0,11
1454899,1047450,2021-04-06,Assembly,"Do pass and be re-referred to the Committee on [Appropriations] with recommendation: To Consent Calendar",8,0,0,0,8
1454901,1035198,2021-03-23,Assembly,"Do pass",9,2,0,0,11
1454901,1044979,2021-04-05,Assembly,"AB 900 Reyes Assembly Third Reading",54,15,9,0,78
1454902,1060961,2021-04-22,Assembly,"Do pass as amended. To Consent Calendar",11,0,0,0,11
1454902,1068286,2021-05-03,Assembly,"AB 901 Calderon Consent Calendar Second Day",76,0,2,0,78
1454904,1054629,2021-04-14,Assembly,"Do pass as amended and be re-referred to the Committee on [Appropriations]",8,0,0,0,8
1454904,1065172,2021-04-28,Assembly,"Do pass",16,0,0,0,16
1454904,1075242,2021-05-10,Assembly,"AB 903 Frazier Assembly Third Reading",70,0,8,0,78
1454908,1064040,2021-04-26,Assembly,"Do pass and be re-referred to the Committee on [Appropriations]",11,4,0,0,15
1454914,1046102,2021-04-06,Assembly,"Do pass and be re-referred to the Committee on [Public Safety]",18,0,1,0,19
1454914,1065220,2021-04-27,Assembly,"Do pass and be re-referred to the Committee on [Appropriations] with recommendation: To Consent Calendar",8,0,0,0,8
1454914,1076943,2021-05-12,Assembly,"Do pass. To Consent Calendar",16,0,0,0,16
1454915,1036541,2021-03-24,Assembly,"Do pass and be re-referred to the Committee on [Appropriations]",12,0,0,0,12
1454915,1053561,2021-04-14,Assembly,"Do pass. To Consent Calendar",16,0,0,0,16
1454916,1064071,2021-04-27,Assembly,"Do pass as amended and be re-referred to the Committee on [Appropriations]",6,0,1,0,7
1454918,1044981,2021-04-05,Assembly,"Do pass and be re-referred to the Committee on [Privacy and Consumer Protection]",13,0,2,0,15
1454918,1060878,2021-04-22,Assembly,"Do pass as amended",10,0,1,0,11
1454921,1066721,2021-04-29,Assembly,"Do pass. To Consent Calendar",11,0,0,0,11
1454921,1074105,2021-05-06,Assembly,"AB 920 Aguiar-Curry Consent Calendar Second Day Regular Session",77,0,1,0,78
1454922,1049884,2021-04-08,Assembly,"Do pass and be re-referred to the Committee on [Appropriations]",9,0,6,0,15
1454924,1065108,2021-04-28,Assembly,"Do pass and be re-referred to the Committee on [Appropriations]",7,0,0,0,7
1454926,1053500,2021-04-13,Assembly,"Do pass and be re-referred to the Committee on [Appropriations] with recommendation: To Consent Calendar",8,0,0,0,8
1454927,1065101,2021-04-28,Assembly,"Do pass and be re-referred to the Committee on [Appropriations]",11,0,0,0,11
1454928,1060853,2021-04-22,Assembly,"Do pass and be re-referred to the Committee on [Appropriations]",11,0,1,0,12
1454929,1060849,2021-04-22,Assembly,"Do pass as amended and be re-referred to the Committee on [Appropriations]",12,0,0,0,12
1454931,1035242,2021-03-23,Assembly,"Do pass as amended and be re-referred to the Committee on [Appropriations]",8,1,2,0,11
1454932,1053541,2021-04-13,Assembly,"Do pass and be re-referred to the Committee on [Appropriations] with recommendation: To Consent Calendar",8,0,0,0,8
1454933,1047449,2021-04-07,Assembly,"Do pass and be re-referred to the Committee on [Appropriations]",8,0,0,0,8
1454935,1065088,2021-04-28,Assembly,"Do pass and be re-referred to the Committee on [Appropriations]",7,0,0,0,7
1454936,1064050,2021-04-27,Assembly,"Do pass and be re-referred to the Committee on [Appropriations]",12,0,3,0,15
1454938,1047432,2021-04-06,Assembly,"Do pass and be re-referred to the Committee on [Judiciary]",5,2,1,0,8
1454938,1057743,2021-04-20,Assembly,"Do pass as amended and be re-referred to the Committee on [Appropriations]",7,2,2,0,11
1454939,1035231,2021-03-23,Assembly,"Do pass. To Consent Calendar",11,0,0,0,11
1454939,1044944,2021-04-05,Assembly,"AB 938 Davies Consent Calendar Second Day Regular Session",74,0,4,0,78
1454940,1065305,2021-04-27,Assembly,"Do pass",8,0,0,0,8
1454941,1035172,2021-03-23,Assembly,"Do pass and be re-referred to the Committee on [Higher Education]",14,0,1,0,15
1454941,1048986,2021-04-08,Assembly,"Do pass and be re-referred to the Committee on [Appropriations]",11,0,1,0,12
1454942,1059296,2021-04-21,Assembly,"Do pass and be re-referred to the Committee on [Appropriations]",8,0,0,0,8
1454943,1063989,2021-04-27,Assembly,"Do pass and be re-referred to the Committee on [Appropriations]",15,0,0,0,15
1454946,1048949,2021-04-07,Assembly,"Do pass and be re-referred to the Committee on [Judiciary] with recommendation: To Consent Calendar",7,0,0,0,7
1454946,1057636,2021-04-20,Assembly,"Do pass and be re-referred to the Committee on [Appropriations] with recommendation: To Consent Calendar",10,0,1,0,11
1454949,1065184,2021-04-27,Assembly,"Do pass and be re-referred to the Committee on [Appropriations] with recommendation: To Consent Calendar",19,0,0,0,19
1454951,1067640,2021-04-29,Assembly,"Do pass and be re-referred to the Committee on [Appropriations]",7,0,1,0,8
1454956,1051943,2021-04-12,Assembly,"Do pass and be re-referred to the Committee on [Communications and Conveyance] with recommendation: To Consent Calendar",15,0,0,0,15
1454956,1065177,2021-04-28,Assembly,"Do pass and be re-referred to the Committee on [Appropriations] with recommendation: To Consent Calendar",13,0,0,0,13
1454958,1048985,2021-04-08,Assembly,"Do pass and be re-referred to the Committee on [Appropriations] with recommendation: To Consent Calendar",22,0,0,0,22
1454958,1059275,2021-04-21,Assembly,"Do pass. To Consent Calendar",14,0,2,0,16
1454958,1066714,2021-04-29,Assembly,"AB 957 Salas Consent Calendar Second Day Regular Session",77,0,1,0,78
1454959,1065229,2021-04-27,Assembly,"Do pass as amended and be re-referred to the Committee on [Appropriations]",8,0,0,0,8
1454960,1073360,2021-05-05,Assembly,"Do pass as amended",8,0,0,0,8
1454961,1059181,2021-04-20,Assembly,"Do pass as amended and be re-referred to the Committee on [Appropriations]",6,2,0,0,8
1454963,1065126,2021-04-28,Assembly,"Do pass and be re-referred to the Committee on [Appropriations]",11,0,0,0,11
1454963,1076960,2021-05-12,Assembly,"Do pass. To Consent Calendar",16,0,0,0,16
1454964,1065274,2021-04-28,Assembly,"Do pass and be re-referred to the Committee on [Appropriations]",11,0,0,0,11
1454966,1067636,2021-04-29,Assembly,"Do pass and be re-referred to the Committee on [Appropriations] with recommendation: To Consent Calendar",8,0,0,0,8
1454967,1065146,2021-04-28,Assembly,"Do pass and be re-referred to the Committee on [Appropriations] with recommendation: To Consent Calendar",7,0,0,0,7
1454968,1048929,2021-04-07,Assembly,"Do pass as amended and be re-referred to the Committee on [Appropriations]",7,0,0,0,7
1454972,1016241,2021-02-25,Assembly,"Be adopted. To third reading",11,0,1,0,12
1454972,1037871,2021-03-25,Senate,"Special Consent ACR30",38,0,2,0,40
1454974,1054606,2021-04-15,Senate,"Do pass as amended, but first amend, and re-refer to the Committee on [Appropriations]",9,0,0,0,9
1454974,1075309,2021-05-10,Senate,"Placed on suspense file",7,0,0,0,7
1454976,1046215,2021-04-06,Senate,"Do pass, but first be re-referred to the Committee on [Appropriations] with the recommendation: To Consent Calendar",5,0,0,0,5
1454976,1056419,2021-04-19,Senate,"Placed on suspense file",7,0,0,0,7
1454979,1062742,2021-04-26,Senate,"Do pass, but first be re-referred to the Committee on [Transportation]",6,0,1,0,7
1454980,1059286,2021-04-21,Senate,"Do pass as amended, but first amend, and re-refer to the Committee on [Appropriations]",8,1,0,0,9
1454980,1075287,2021-05-10,Senate,"Placed on suspense file",7,0,0,0,7
1454981,1031903,2021-03-18,Senate,"Do pass, but first be re-referred to the Committee on [Appropriations]",7,0,2,0,9
1454981,1044953,2021-04-05,Senate,"Placed on suspense file",7,0,0,0,7
1454982,1048891,2021-04-08,Senate,"Do pass as amended, but first amend, and re-refer to the Committee on [Housing]",4,1,0,0,5
1454982,1066754,2021-04-29,Senate,"Do pass, but first be re-referred to the Committee on [Appropriations]",7,1,1,0,9
1454982,1075319,2021-05-10,Senate,"Placed on suspense file",7,0,0,0,7
1454983,1028400,2021-03-15,Senate,"Do pass as amended, but first amend, and re-refer to the Committee on [Appropriations]",14,0,0,0,14
1454983,1050785,2021-04-12,Senate,"Senate 3rd Reading SB479 Laird",39,0,1,0,40
1454984,1054703,2021-04-15,Senate,"Do pass, but first be re-referred to the Committee on [Appropriations]",5,0,0,0,5
1454985,1064119,2021-04-27,Senate,"Do pass, but first be re-referred to the Committee on [Appropriations]",4,1,0,0,5
1454985,1075301,2021-05-10,Senate,"Placed on suspense file",7,0,0,0,7
1454987,1064171,2021-04-27,Senate,"Do pass, but first be re-referred to the Committee on [Appropriations]",4,1,0,0,5
1454987,1075373,2021-05-10,Senate,"Placed on suspense file",7,0,0,0,7
1454988,1023834,2021-03-08,Senate,"Do pass as amended, but first amend, and re-refer to the Committee on [Appropriations]",11,0,3,0,14
1454988,1074137,2021-05-06,Senate,"Senate 3rd Reading SB484 Archuleta",35,1,4,0,40
1454989,1074166,2021-05-06,Senate,"Do pass as amended, but first amend, and re-refer to the Committee on [Appropriations]",5,0,0,0,5
1454990,1064051,2021-04-27,Senate,"Do pass, but first be re-referred to the Committee on [Appropriations]",6,3,8,0,17
1454991,1053497,2021-04-14,Senate,"Do pass, but first be re-referred to the Committee on [Appropriations] with the recommendation: To Consent Calendar",11,0,0,0,11
1454991,1075331,2021-05-10,Senate,"Consent Calendar SB487",37,0,3,0,40
1454992,1030805,2021-03-17,Senate,"Do pass, but first be re-referred to the Committee on [Appropriations]",7,0,0,0,7
1454992,1044948,2021-04-05,Senate,"Placed on suspense file",7,0,0,0,7
1454993,1031879,2021-03-18,Senate,"Do pass as amended, but first amend, and re-refer to the Committee on [Appropriations]",5,0,0,0,5
1454993,1068167,2021-05-03,Senate,"Senate 3rd Reading SB489 Laird",36,0,4,0,40
1454994,1054593,2021-04-15,Senate,"Do pass, but first be re-referred to the Committee on [Appropriations]",8,0,1,0,9
1454994,1068236,2021-05-03,Senate,"Placed on suspense file",6,0,1,0,7
1454995,1037848,2021-03-25,Senate,"Do pass as amended, but first amend, and re-refer to the Committee on [Public Safety]",5,0,0,0,5
1454995,1064074,2021-04-27,Senate,"Do pass, but first be re-referred to the Committee on [Appropriations] with the recommendation: To Consent Calendar",5,0,0,0,5
1454995,1075379,2021-05-10,Senate,"Placed on suspense file",7,0,0,0,7
1454996,1065277,2021-04-28,Senate,"Do pass, but first be re-referred to the Committee on [Appropriations]",11,0,0,0,11
1454997,1057652,2021-04-20,Senate,"Do pass, but first be re-referred to the Committee on [Appropriations]",4,1,0,0,5
1454997,1068153,2021-05-03,Senate,"Placed on suspense file",6,0,1,0,7
1454998,1025086,2021-03-09,Senate,"Do pass and be ordered to the Consent Calendar",14,0,0,0,14
1454998,1033617,2021-03-22,Senate,"Consent Calendar SB494",37,0,3,0,40
1454999,1066794,2021-04-29,Senate,"Do pass, but first be re-referred to the Committee on [Governance and Finance]",2,0,5,0,7
1455000,1064005,2021-04-27,Senate,"Do pass, but first be re-referred to the Committee on [Appropriations] with the recommendation: To Consent Calendar",9,0,0,0,9
1455000,1075290,2021-05-10,Senate,"Placed on suspense file",7,0,0,0,7
1455001,1047528,2021-04-07,Senate,"Do pass, but first be re-referred to the Committee on [Human Services]",9,0,0,0,9
1455001,1057724,2021-04-20,Senate,"Do pass as amended, but first amend, and re-refer to the Committee on [Appropriations] with the recommendation: To Consent Calendar",5,0,0,0,5
1455001,1075325,2021-05-10,Senate,"Placed on suspense file",7,0,0,0,7
1455002,1035169,2021-03-23,Senate,"Do pass, but first be re-referred to the Committee on [Military & Veterans Affairs] with the recommendation: To Consent Calendar",11,0,0,0,11
1455002,1053506,2021-04-14,Senate,"Do pass and be ordered to the Consent Calendar",7,0,0,0,7
1455002,1060837,2021-04-22,Senate,"Consent Calendar SB498",38,0,2,0,40
1455004,1051993,2021-04-13,Senate,"Do pass as amended, but first amend, and re-refer to the Committee on [Appropriations]",12,2,3,0,17
1455004,1075240,2021-05-10,Senate,"Placed on suspense file",7,0,0,0,7
1455005,1035228,2021-03-23,Senate,"Do pass as amended, but first amend, and re-refer to the Committee on [Appropriations] with the recommendation: To Consent Calendar",11,0,0,0,11
1455005,1056324,2021-04-19,Senate,"Placed on suspense file",7,0,0,0,7
1455006,1028403,2021-03-15,Senate,"Do pass, but first be re-referred to the Committee on [Appropriations]",5,0,2,0,7
1455006,1033652,2021-03-22,Senate,"Placed on suspense file",7,0,0,0,7
1455007,1028414,2021-03-15,Senate,"Do pass, but first be re-referred to the Committee on [Appropriations]",4,1,0,0,5
1455007,1033659,2021-03-22,Senate,"Placed on suspense file",7,0,0,0,7
1455008,1028390,2021-03-15,Senate,"Do pass, but first be re-referred to the Committee on [Public Safety]",5,0,0,0,5
1455008,1057618,2021-04-20,Senate,"Do pass, but first be re-referred to the Committee on [Appropriations] with the recommendation: To Consent Calendar",5,0,0,0,5
1455008,1068265,2021-05-03,Senate,"Placed on suspense file",6,0,1,0,7
1455009,1046099,2021-04-05,Senate,"Do pass as amended, but first amend, and re-refer to the Committee on [Judiciary] with the recommendation: To Consent Calendar",5,0,0,0,5
1455009,1059274,2021-04-20,Senate,"Do pass, but first be re-referred to the Committee on [Appropriations] with the recommendation: To Consent Calendar",11,0,0,0,11
1455009,1075252,2021-05-10,Senate,"Consent Calendar SB505",37,0,3,0,40
1455011,1036471,2021-03-24,Senate,"Do pass as amended, but first amend, and re-refer to the Committee on [Judiciary]",11,0,0,0,11
1455011,1047535,2021-04-06,Senate,"Do pass as amended, but first amend, and re-refer to the Committee on [Appropriations]",11,0,0,0,11
1455011,1068250,2021-05-03,Senate,"Placed on suspense file",6,0,1,0,7
1455013,1056427,2021-04-19,Senate,"Do pass as amended, but first amend, and re-refer to the Committee on [Appropriations]",13,0,1,0,14
1455013,1077575,2021-05-13,Senate,"Senate 3rd Reading SB509 Wilk et al. Urgency Clause",38,0,2,0,40
1455014,1047439,2021-04-07,Senate,"Do pass as amended, but first amend, and re-refer to the Committee on [Appropriations]",9,1,1,0,11
1455014,1068228,2021-05-03,Senate,"Placed on suspense file",6,0,1,0,7
1455016,1052014,2021-04-13,Senate,"Do pass, but first be re-referred to the Committee on [Appropriations] with the recommendation: To Consent Calendar",16,0,1,0,17
1455016,1068182,2021-05-03,Senate,"Placed on suspense file",6,0,1,0,7
1455020,1047444,2021-04-06,Senate,"Do pass as amended, but first amend, and re-refer to the Committee on [Health]",11,0,0,0,11
1455020,1059214,2021-04-21,Senate,"Do pass, but first be re-referred to the Committee on [Appropriations]",10,0,1,0,11
1455020,1075239,2021-05-10,Senate,"Senate 3rd Reading SB516 Eggman et al",34,0,6,0,40
1455022,1057662,2021-04-20,Senate,"Do pass, but first be re-referred to the Committee on [Judiciary]",5,0,0,0,5
1455022,1065256,2021-04-27,Senate,"Do pass, but first be re-referred to the Committee on [Appropriations] with the recommendation: To Consent Calendar",11,0,0,0,11
1455023,1046204,2021-04-06,Senate,"Do pass, but first be re-referred to the Committee on [Health]",4,1,0,0,5
1455023,1053508,2021-04-14,Senate,"Do pass as amended, but first amend, and re-refer to the Committee on [Appropriations]",6,2,3,0,11
1455023,1068211,2021-05-03,Senate,"Placed on suspense file",6,0,1,0,7
1455024,1029597,2021-03-16,Senate,"Do pass as amended, but first amend, and re-refer to the Committee on [Appropriations]",9,0,0,0,9
1455024,1045021,2021-04-05,Senate,"Do pass",7,0,0,0,7
1455024,1066792,2021-04-29,Senate,"Senate 3rd Reading SB520 Wilk et al",36,0,4,0,40
1455025,1047540,2021-04-07,Senate,"Do pass as amended, but first amend, and re-refer to the Committee on [Appropriations]",11,0,0,0,11
1455027,1046172,2021-04-05,Senate,"Do pass, but first be re-referred to the Committee on [Health]",4,0,1,0,5
1455027,1065214,2021-04-28,Senate,"Do pass as amended, but first amend, and re-refer to the Committee on [Appropriations]",8,2,1,0,11
1455028,1044966,2021-04-05,Senate,"Do pass as amended, but first amend, and re-refer to the Committee on [Health]",11,0,3,0,14
1455028,1065307,2021-04-28,Senate,"Do pass as amended, but first amend, and re-refer to the Committee on [Appropriations]",10,0,1,0,11
1455029,1059299,2021-04-21,Senate,"Do pass, but first be re-referred to the Committee on [Education] with the recommendation: To Consent Calendar",11,0,0,0,11
1455029,1065233,2021-04-28,Senate,"Do pass, but first be re-referred to the Committee on [Appropriations] with the recommendation: To Consent Calendar",7,0,0,0,7
1455029,1075347,2021-05-10,Senate,"Placed on suspense file",7,0,0,0,7
1455032,1025116,2021-03-09,Senate,"Do pass as amended, but first amend, and re-refer to the Committee on [Health]",4,0,0,0,4
1455032,1026096,2021-03-09,Senate,"Do pass, but first be re-referred to the Committee on [Health]",4,0,0,0,4
1455032,1065102,2021-04-28,Senate,"Do pass, but first be re-referred to the Committee on [Appropriations] with the recommendation: To Consent Calendar",11,0,0,0,11
1455032,1075278,2021-05-10,Senate,"Placed on suspense file",7,0,0,0,7
1455033,1062778,2021-04-26,Senate,"Do pass, but first be re-referred to the Committee on [Appropriations]",14,0,0,0,14
1455033,1077593,2021-05-13,Senate,"Senate 3rd Reading SB529 Hertzberg",38,0,2,0,40
1455035,1047486,2021-04-07,Senate,"Do pass as amended, but first amend, and re-refer to the Committee on [Judiciary]",7,2,0,0,9
1455035,1065139,2021-04-27,Senate,"Do pass as amended, but first amend, and re-refer to the Committee on [Appropriations]",9,1,1,0,11
1455035,1077604,2021-05-13,Senate,"Senate 3rd Reading SB531 Wieckowski",29,9,2,0,40
1455036,1030796,2021-03-17,Senate,"Do pass as amended, but first amend, and re-refer to the Committee on [Appropriations] with the recommendation: To Consent Calendar",7,0,0,0,7
1455036,1056369,2021-04-19,Senate,"Placed on suspense file",7,0,0,0,7
1455037,1056432,2021-04-19,Senate,"Do pass as amended, but first amend, and re-refer to the Committee on [Judiciary]",9,3,2,0,14
1455037,1065295,2021-04-27,Senate,"Do pass as amended, but first amend, and re-refer to the Committee on [Appropriations]",9,2,0,0,11
1455038,1045007,2021-04-05,Senate,"Do pass, but first be re-referred to the Committee on [Appropriations]",14,0,0,0,14
1455038,1056376,2021-04-19,Senate,"Do pass",7,0,0,0,7
1455038,1074130,2021-05-06,Senate,"Senate 3rd Reading SB534 Jones",37,0,3,0,40
1455039,1059160,2021-04-21,Senate,"Do pass as amended, but first amend, and re-refer to the Committee on [Appropriations]",11,0,0,0,11
1455039,1075397,2021-05-10,Senate,"Placed on suspense file",7,0,0,0,7
1455041,1057748,2021-04-20,Senate,"Do pass as amended, but first amend, and re-refer to the Committee on [Judiciary]",5,0,0,0,5
1455041,1065176,2021-04-27,Senate,"Do pass as amended, but first amend, and re-refer to the Committee on [Appropriations] with the recommendation: To Consent Calendar",11,0,0,0,11
1455041,1075357,2021-05-10,Senate,"Placed on suspense file",7,0,0,0,7
1455042,1047455,2021-04-06,Senate,"Do pass as amended, but first amend, and re-refer to the Committee on [Rules]",11,0,0,0,11
1455042,1064080,2021-04-27,Senate,"Do pass, but first be re-referred to the Committee on [Appropriations] with the recommendation: To Consent Calendar",5,0,0,0,5
1455042,1075271,2021-05-10,Senate,"Placed on suspense file",7,0,0,0,7
1456700,1049006,2021-04-08,Assembly,"Do pass and be re-referred to the Committee on [Military and Veterans Affairs]",11,0,1,0,12
1456700,1053564,2021-04-08,Assembly,"Do pass as amended and be re-referred to the Committee on [Military and Veterans Affairs]",11,0,1,0,12
1456700,1065135,2021-04-28,Assembly,"Do pass and be re-referred to the Committee on [Appropriations] with recommendation: To Consent Calendar",11,0,0,0,11
1456700,1076959,2021-05-12,Assembly,"Do pass. To Consent Calendar",16,0,0,0,16
1456701,1059247,2021-04-20,Assembly,"Do pass as amended and be re-referred to the Committee on [Appropriations]",8,0,0,0,8
1456702,1047525,2021-04-07,Assembly,"Do pass and be re-referred to the Committee on [Appropriations] with recommendation: To Consent Calendar",8,0,0,0,8
1456702,1059344,2021-04-21,Assembly,"Do pass. To Consent Calendar",14,0,2,0,16
1456702,1066736,2021-04-29,Assembly,"AB 1004 Calderon Consent Calendar Second Day Regular Session",77,0,1,0,78
1456704,1047431,2021-04-07,Assembly,"Do pass and be re-referred to the Committee on [Appropriations] with recommendation: To Consent Calendar",8,0,0,0,8
1456705,1047594,2021-04-06,Assembly,"Do pass and be re-referred to the Committee on [Judiciary] with recommendation: To Consent Calendar",8,0,0,0,8
1456705,1051965,2021-04-13,Assembly,"Do pass and be re-referred to the Committee on [Appropriations] with recommendation: To Consent Calendar",11,0,0,0,11
1456707,1054682,2021-04-15,Assembly,"Do pass and be re-referred to the Committee on [Appropriations]",10,0,1,0,11
1456708,1035227,2021-03-23,Assembly,"Do pass as amended and be re-referred to the Committee on [Appropriations]",17,0,2,0,19
1456708,1053504,2021-04-14,Assembly,"Do pass",15,0,1,0,16
1456708,1056481,2021-04-19,Assembly,"AB 1010 Berman Assembly Third Reading",72,2,5,0,79
1456710,1054626,2021-04-15,Assembly,"Do pass and be re-referred to the Committee on [Appropriations] with recommendation: To Consent Calendar",11,0,0,0,11
1456712,1057692,2021-04-20,Assembly,"Do pass and be re-referred to the Committee on [Appropriations]",17,0,2,0,19
1456713,1057701,2021-04-20,Assembly,"Do pass and be re-referred to the Committee on [Appropriations] with recommendation: To Consent Calendar",19,0,0,0,19
1456715,1065118,2021-04-28,Assembly,"Do pass and be re-referred to the Committee on [Appropriations]",7,1,0,0,8
1456718,1046160,2021-04-06,Assembly,"Do pass as amended and be re-referred to the Committee on [Health]",9,2,0,0,11
1456718,1057657,2021-04-20,Assembly,"Do pass and be re-referred to the Committee on [Appropriations]",13,0,2,0,15
1456719,1054661,2021-04-14,Assembly,"Do pass as amended and be re-referred to the Committee on [Appropriations]",8,0,0,0,8
1456721,1048912,2021-04-08,Assembly,"Do pass and be re-referred to the Committee on [Appropriations]",7,0,0,0,7
1456722,1047426,2021-04-07,Assembly,"Do pass and be re-referred to the Committee on [Appropriations] with recommendation: To Consent Calendar",9,0,0,0,9
1456724,1057749,2021-04-20,Assembly,"Do pass and be re-referred to the Committee on [Appropriations]",19,0,0,0,19
1456727,1054684,2021-04-15,Assembly,"Do pass and be re-referred to the Committee on [Local Government]",6,1,1,0,8
1456727,1065096,2021-04-28,Assembly,"Do pass and be re-referred to the Committee on [Appropriations]",6,2,0,0,8
1456727,1076953,2021-05-12,Assembly,"Do pass",12,4,0,0,16
1456729,1054617,2021-04-15,Assembly,"Do pass and be re-referred to the Committee on [Appropriations]",6,0,1,0,7
1456729,1065104,2021-04-28,Assembly,"Do pass. To Consent Calendar",16,0,0,0,16
1456729,1074182,2021-05-06,Assembly,"AB 1031 Villapudua Consent Calendar Second Day Regular Session",77,0,1,0,78
1456730,1054689,2021-04-15,Assembly,"Do pass and be re-referred to the Committee on [Military and Veterans Affairs]",7,0,0,0,7
1456731,1060973,2021-04-22,Assembly,"Do pass and be re-referred to the Committee on [Judiciary]",7,0,0,0,7
1456731,1064085,2021-04-27,Assembly,"Do pass as amended and be re-referred to the Committee on [Appropriations]",11,0,0,0,11
1456732,1057685,2021-04-20,Assembly,"Do pass",12,0,7,0,19
1456733,1051922,2021-04-12,Assembly,"Do pass and be re-referred to the Committee on [Appropriations]",15,0,0,0,15
1456734,1064129,2021-04-27,Assembly,"Do pass and be re-referred to the Committee on [Appropriations] with recommendation: To Consent Calendar",6,0,1,0,7
1456735,1064123,2021-04-27,Assembly,"Do pass as amended and be re-referred to the Committee on [Appropriations]",6,0,1,0,7
1456736,1057638,2021-04-20,Assembly,"Do pass and be re-referred to the Committee on [Appropriations]",14,1,0,0,15
1456737,1036460,2021-03-24,Assembly,"Do pass and be re-referred to the Committee on [Appropriations] with recommendation: To Consent Calendar",7,0,0,0,7
1456737,1053539,2021-04-14,Assembly,"Do pass. To Consent Calendar",16,0,0,0,16
1456737,1068233,2021-05-03,Assembly,"AB 1039 Nguyen Assembly Third Reading",77,0,1,0,78
1456738,1049029,2021-04-08,Assembly,"Do pass as amended and be re-referred to the Committee on [Appropriations]",7,3,2,0,12
1456739,1048931,2021-04-08,Assembly,"Do pass and be re-referred to the Committee on [Insurance]",5,2,0,0,7
1456740,1051916,2021-04-13,Assembly,"Do pass and be re-referred to the Committee on [Appropriations]",12,2,1,0,15
1456740,1065076,2021-04-28,Assembly,"Do pass",12,4,0,0,16
1456741,1067606,2021-04-29,Assembly,"Do pass as amended and be re-referred to the Committee on [Appropriations]",6,2,0,0,8
1456741,1076942,2021-05-12,Assembly,"Do pass",12,4,0,0,16
1456744,1051877,2021-04-13,Assembly,"Do pass and be re-referred to the Committee on [Appropriations] with recommendation: To Consent Calendar",15,0,0,0,15
1456745,1045014,2021-04-05,Assembly,"Do pass and be re-referred to the Committee on [Appropriations] with recommendation: To Consent Calendar",14,0,1,0,15
1456746,1066789,2021-04-29,Assembly,"Do pass",7,0,0,0,7
1456748,1064046,2021-04-27,Assembly,"Do pass and be re-referred to the Committee on [Appropriations]",15,0,0,0,15
1456749,1047538,2021-04-07,Assembly,"Do pass and be re-referred to the Committee on [Health] with recommendation: To Consent Calendar",8,0,0,0,8
1456749,1057654,2021-04-20,Assembly,"Do pass and be re-referred to the Committee on [Appropriations] with recommendation: To Consent Calendar",15,0,0,0,15
1456753,1049017,2021-04-07,Assembly,"Do pass as amended and be re-referred to the Committee on [Human Services]",7,0,0,0,7
1456753,1059265,2021-04-21,Assembly,"Do pass as amended, and be re-referred to the Committee on [Appropriations] with recommendation: To Consent Calendar",8,0,0,0,8
1456755,1059203,2021-04-20,Assembly,"Do pass and be re-referred to the Committee on [Appropriations] with recommendation: To Consent Calendar",8,0,0,0,8
1456755,1073418,2021-05-05,Assembly,"Do pass. To Consent Calendar",16,0,0,0,16
1456755,1077521,2021-05-13,Assembly,"AB 1057 Petrie-Norris Consent Calendar Second Day Regular Session",75,0,3,0,78
1456756,1047496,2021-04-07,Assembly,"Do pass as amended and be re-referred to the Committee on [Appropriations]",15,0,0,0,15
1456756,1059268,2021-04-21,Assembly,"Do pass. To Consent Calendar",14,0,2,0,16
1456756,1066833,2021-04-29,Assembly,"AB 1058 Cristina Garcia Consent Calendar Second Day Regular Session",77,0,1,0,78
1456758,1057738,2021-04-19,Assembly,"Do pass. To Consent Calendar",6,0,1,0,7
1456759,1068194,2021-05-03,Assembly,"Do pass as amended",7,0,1,0,8
1456759,1077571,2021-05-13,Assembly,"AB 1061 Lee Assembly Third Reading",48,4,26,0,78
1456760,1072249,2021-05-04,Assembly,"Do pass as amended",11,0,0,0,11
1456762,1065103,2021-04-27,Assembly,"Do pass and be re-referred to the Committee on [Appropriations] with recommendation: To Consent Calendar",19,0,0,0,19
1456763,1046104,2021-04-05,Assembly,"Do pass and be re-referred to the Committee on [Appropriations]",10,0,1,0,11
1456763,1059216,2021-04-21,Assembly,"Do pass. To Consent Calendar",14,0,2,0,16
1456763,1068288,2021-05-03,Assembly,"AB 1065 Maienschein Assembly Third Reading",77,0,1,0,78
1456764,1059152,2021-04-21,Assembly,"Do pass and be re-referred to the Committee on [Appropriations]",6,2,1,0,9
1456768,1060975,2021-04-22,Assembly,"Do pass as amended and be re-referred to the Committee on [Appropriations]",20,0,2,0,22
1456769,1045026,2021-04-05,Assembly,"Do pass. To Consent Calendar",7,0,0,0,7
1456770,1064020,2021-04-27,Assembly,"Do pass and be re-referred to the Committee on [Appropriations] with recommendation: To Consent Calendar",6,0,1,0,7
1456771,1048934,2021-04-08,Assembly,"Do pass and be re-referred to the Committee on [Appropriations]",12,0,0,0,12
1456772,1060857,2021-04-22,Assembly,"Do pass and be re-referred to the Committee on [Appropriations]",5,2,0,0,7
1456772,1073382,2021-05-05,Assembly,"Do pass",12,4,0,0,16
1456774,1056373,2021-04-19,Assembly,"Do pass and be re-referred to the Committee on [Privacy and Consumer Protection] with recommendation: To Consent Calendar",15,0,0,0,15
1456774,1060821,2021-04-22,Assembly,"Do pass and be re-referred to the Committee on [Appropriations] with recommendation: To Consent Calendar",11,0,0,0,11
1456777,1046130,2021-04-06,Assembly,"Do pass as amended. To Consent Calendar",11,0,0,0,11
1456777,1054709,2021-04-15,Assembly,"AB 1079 Gallagher Consent Calendar Second Day",75,0,3,0,78
1456780,1035214,2021-03-23,Assembly,"Do pass and be re-referred to the Committee on [Appropriations] with recommendation: To Consent Calendar",15,0,0,0,15
1456781,1057617,2021-04-20,Assembly,"Do pass and be re-referred to the Committee on [Appropriations] with recommendation: To Consent Calendar",7,0,0,0,7
1456782,1046193,2021-04-06,Assembly,"Do pass and be re-referred to the Committee on [Judiciary]",11,4,4,0,19
1456782,1064140,2021-04-27,Assembly,"Do pass as amended and be re-referred to the Committee on [Appropriations]",7,3,1,0,11
1456783,1054723,2021-04-14,Assembly,"Do pass and be re-referred to the Committee on [Appropriations] with recommendation: To Consent Calendar",8,0,0,0,8
1456784,1036540,2021-03-24,Assembly,"Do pass as amended and be re-referred to the Committee on [Appropriations]",10,0,1,0,11
1456785,1047480,2021-04-07,Assembly,"Do pass as amended and be re-referred to the Committee on [Natural Resources]",8,3,4,0,15
1456785,1065234,2021-04-28,Assembly,"Do pass and be re-referred to the Committee on [Appropriations]",8,3,0,0,11
1456787,1054726,2021-04-15,Assembly,"Do pass and be re-referred to the Committee on [Privacy and Consumer Protection]",10,0,2,0,12
1456787,1060864,2021-04-22,Assembly,"Do pass as amended and be re-referred to the Committee on [Appropriations]",8,1,2,0,11
1456788,1067627,2021-04-29,Assembly,"Do pass and be re-referred to the Committee on [Appropriations]",7,1,0,0,8
1456789,1073375,2021-05-05,Assembly,"Do pass",7,0,1,0,8
1456792,1052028,2021-04-13,Assembly,"Do pass and be re-referred to the Committee on [Judiciary] with recommendation: To Consent Calendar",15,0,0,0,15
1456792,1064011,2021-04-27,Assembly,"Do pass and be re-referred to the Committee on [Appropriations] with recommendation: To Consent Calendar",11,0,0,0,11
1456793,1067612,2021-04-29,Assembly,"Do pass and be re-referred to the Committee on [Appropriations] with recommendation: To Consent Calendar",8,0,0,0,8
1456793,1076972,2021-05-12,Assembly,"Do pass. To Consent Calendar",16,0,0,0,16
1456794,1046218,2021-04-06,Assembly,"Do pass as amended",11,0,0,0,11
1456796,1051953,2021-04-13,Assembly,"Do pass and be re-referred to the Committee on [Appropriations]",15,0,0,0,15
1456798,1054710,2021-04-14,Assembly,"Do pass and be re-referred to the Committee on [Emergency Management]",10,2,1,0,13
1456798,1057741,2021-04-19,Assembly,"Do pass and be re-referred to the Committee on [Appropriations]",5,2,0,0,7
1456799,1067634,2021-04-29,Assembly,"Do pass and be re-referred to the Committee on [Judiciary]",7,0,1,0,8
1456799,1072214,2021-05-04,Assembly,"Do pass",10,0,1,0,11
1456800,1035151,2021-03-23,Assembly,"Do pass",17,0,2,0,19
1456800,1048961,2021-04-08,Assembly,"AB 1102 Low Consent Calendar Second Day",74,0,4,0,78
1456801,1054635,2021-04-15,Assembly,"Do pass and be re-referred to the Committee on [Emergency Management]",11,0,0,0,11
1456801,1057650,2021-04-19,Assembly,"Do pass as amended and be re-referred to the Committee on [Appropriations]",7,0,0,0,7
1456802,1046157,2021-04-06,Assembly,"Do pass as amended and be re-referred to the Committee on [Appropriations]",15,0,0,0,15
1456803,1060831,2021-04-22,Assembly,"Do pass and be re-referred to the Committee on [Appropriations]",5,1,1,0,7
1456804,1064156,2021-04-27,Assembly,"Do pass as amended and be re-referred to the Committee on [Appropriations]",6,0,1,0,7
1456808,1064052,2021-04-27,Assembly,"Do pass as amended and be re-referred to the Committee on [Appropriations]",6,0,1,0,7
1456809,1060920,2021-04-22,Assembly,"Do pass and be re-referred to the Committee on [Appropriations]",12,0,0,0,12
1456810,1048952,2021-04-07,Assembly,"Do pass as amended, and be re-referred to the Committee on [Appropriations] with recommendation: To Consent Calendar",7,0,0,0,7
1456810,1065162,2021-04-28,Assembly,"Do pass. To Consent Calendar",16,0,0,0,16
1456810,1074195,2021-05-06,Assembly,"AB 1112 Carrillo Consent Calendar Second Day Regular Session",77,0,1,0,78
1456811,1048978,2021-04-08,Assembly,"Do pass and be re-referred to the Committee on [Appropriations]",11,0,1,0,12
1456812,1051990,2021-04-13,Assembly,"Do pass as amended and be re-referred to the Committee on [Arts, Entertainment, Sports, Tourism, and Internet Media]",7,3,1,0,11
1456816,1060903,2021-04-22,Assembly,"Do pass and be re-referred to the Committee on [Appropriations]",8,1,3,0,12
1456817,1048890,2021-04-08,Assembly,"Do pass and be re-referred to the Committee on [Judiciary]",5,2,0,0,7
1456817,1057620,2021-04-20,Assembly,"Do pass as amended and be re-referred to the Committee on [Appropriations]",8,2,1,0,11
1456821,1057659,2021-04-19,Assembly,"Do pass and be re-referred to the Committee on [Appropriations]",7,0,0,0,7
1456822,1073378,2021-05-05,Assembly,"Do pass",8,0,0,0,8
1456824,1065190,2021-04-28,Assembly,"Do pass and be re-referred to the Committee on [Appropriations]",7,0,0,0,7
1456825,1065273,2021-04-27,Assembly,"Do pass as amended and be re-referred to the Committee on [Appropriations]",6,2,0,0,8
1456828,1046165,2021-04-06,Assembly,"Do pass as amended and be re-referred to the Committee on [Appropriations]",12,0,3,0,15
1456829,1046182,2021-04-06,Assembly,"Do pass and be re-referred to the Committee on [Appropriations]",13,1,1,0,15
1456830,1064047,2021-04-27,Assembly,"Do pass as amended and be re-referred to the Committee on [Appropriations]",15,0,0,0,15
1456833,1067623,2021-04-29,Assembly,"Do pass and be re-referred to the Committee on [Appropriations]",8,0,0,0,8
1456834,1054705,2021-04-15,Assembly,"Do pass and be re-referred to the Committee on [Appropriations] with recommendation: To Consent Calendar",12,0,0,0,12
1456835,1054656,2021-04-15,Assembly,"Do pass as amended and be re-referred to the Committee on [Appropriations]",6,1,0,0,7
1456836,1035235,2021-03-23,Assembly,"Do pass and be re-referred to the Committee on [Judiciary]",17,0,2,0,19
1456836,1057708,2021-04-20,Assembly,"Do pass as amended and be re-referred to the Committee on [Appropriations]",10,0,1,0,11
1456837,1059248,2021-04-21,Assembly,"Do pass as amended and be re-referred to the Committee on [Appropriations]",12,0,3,0,15
1456838,1047581,2021-04-07,Assembly,"Do pass and be re-referred to the Committee on [Judiciary] with recommendation: To Consent Calendar",8,0,0,0,8
1456838,1051901,2021-04-13,Assembly,"Do pass. To Consent Calendar",11,0,0,0,11
1456838,1056482,2021-04-19,Assembly,"AB 1140 Robert Rivas Consent Calendar Second Day Regular Session",78,0,1,0,79
1456841,1051946,2021-04-13,Assembly,"Do pass",10,0,1,0,11
1456841,1056483,2021-04-19,Assembly,"AB 1143 Berman Assembly Third Reading",77,0,2,0,79
1456842,1064022,2021-04-27,Assembly,"Do pass as amended and be re-referred to the Committee on [Appropriations]",15,0,0,0,15
1456842,1076962,2021-05-12,Assembly,"Do pass. To Consent Calendar",16,0,0,0,16
1456844,1052010,2021-04-13,Assembly,"Do pass as amended and be re-referred to the Committee on [Revenue and Taxation]",7,0,0,0,7
1456845,1044985,2021-04-05,Assembly,"Do pass and be re-referred to the Committee on [Natural Resources]",10,3,2,0,15
1456845,1053584,2021-04-14,Assembly,"Do pass and be re-referred to the Committee on [Appropriations]",8,3,0,0,11
1456846,1054601,2021-04-15,Assembly,"Do pass and be re-referred to the Committee on [Appropriations] with recommendation: To Consent Calendar",13,0,0,0,13
1456846,1065194,2021-04-28,Assembly,"Do pass. To Consent Calendar",16,0,0,0,16
1456846,1074164,2021-05-06,Assembly,"AB 1148 Daly Consent Calendar Second Day Regular Session",77,0,1,0,78
1456847,1060884,2021-04-22,Assembly,"Do pass as amended and be re-referred to the Committee on [Appropriations]",19,0,3,0,22
1456847,1076927,2021-05-12,Assembly,"Do pass. To Consent Calendar",16,0,0,0,16
1456848,1049011,2021-04-08,Assembly,"Do pass and be re-referred to the Committee on [Appropriations] with recommendation: To Consent Calendar",22,0,0,0,22
1456849,1045010,2021-04-05,Assembly,"Do pass and be re-referred to the Committee on [Appropriations] with recommendation: To Consent Calendar",14,0,1,0,15
1456853,1048917,2021-04-08,Assembly,"Do pass and be re-referred to the Committee on [Appropriations] with recommendation: To Consent Calendar",22,0,0,0,22
1456854,1059272,2021-04-21,Assembly,"Do pass and be re-referred to the Committee on [Appropriations] with recommendation: To Consent Calendar",15,0,0,0,15
1456855,1044947,2021-04-05,Assembly,"Do pass and be re-referred to the Committee on [Appropriations] with recommendation: To Consent Calendar",14,0,1,0,15
1456855,1059201,2021-04-21,Assembly,"Do pass. To Consent Calendar",14,0,2,0,16
1456855,1066749,2021-04-29,Assembly,"AB 1157 Lee Consent Calendar Second Day Regular Session",77,0,1,0,78
1456856,1051963,2021-04-13,Assembly,"Do pass and be re-referred to the Committee on [Insurance]",15,0,0,0,15
1456856,1066811,2021-04-29,Assembly,"Do pass and be re-referred to the Committee on [Appropriations] with recommendation: To Consent Calendar",13,0,0,0,13
1456860,1057682,2021-04-20,Assembly,"Do pass as amended and be re-referred to the Committee on [Appropriations]",13,1,1,0,15
1456862,1064045,2021-04-26,Assembly,"Do pass as amended and be re-referred to the Committee on [Appropriations]",15,0,0,0,15
1456862,1076931,2021-05-12,Assembly,"Do pass. To Consent Calendar",16,0,0,0,16
1456863,1065262,2021-04-27,Assembly,"Do pass and be re-referred to the Committee on [Appropriations]",6,2,0,0,8
1456865,1060832,2021-04-22,Assembly,"Do pass and be re-referred to the Committee on [Appropriations] with recommendation: To Consent Calendar",21,0,1,0,22
1456867,1064012,2021-04-27,Assembly,"Do pass as amended, and be re-referred to the Committee on [Appropriations] with recommendation: To Consent Calendar",15,0,0,0,15
1456868,1049023,2021-04-08,Assembly,"Do pass and be re-referred to the Committee on [Appropriations] with recommendation: To Consent Calendar",22,0,0,0,22
1456868,1059262,2021-04-21,Assembly,"Do pass. To Consent Calendar",14,0,2,0,16
1456868,1066810,2021-04-29,Assembly,"AB 1170 Bigelow Consent Calendar Second Day Regular Session",77,0,1,0,78
1456869,1065218,2021-04-27,Assembly,"Do pass. To Consent Calendar",6,0,1,0,7
1456870,1066751,2021-04-29,Assembly,"Do pass as amended and be re-referred to the Committee on [Appropriations]",11,0,1,0,12
1456871,1048899,2021-04-08,Assembly,"Do pass and be re-referred to the Committee on [Appropriations] with recommendation: To Consent Calendar",22,0,0,0,22
1456871,1076941,2021-05-12,Assembly,"Do pass. To Consent Calendar",16,0,0,0,16
1456872,1054645,2021-04-15,Assembly,"Do pass and be re-referred to the Committee on [Local Government]",8,0,0,0,8
1456872,1065318,2021-04-28,Assembly,"Do pass and be re-referred to the Committee on [Appropriations]",7,0,1,0,8
1456872,1076965,2021-05-12,Assembly,"Do pass. To Consent Calendar",16,0,0,0,16
1456874,1065246,2021-04-28,Assembly,"Do pass and be re-referred to the Committee on [Appropriations]",8,3,2,0,13
1456875,1066765,2021-04-29,Assembly,"Do pass as amended and be re-referred to the Committee on [Appropriations]",7,4,1,0,12
1456876,1057625,2021-04-20,Assembly,"Do pass as amended and be re-referred to the Committee on [Appropriations]",15,0,0,0,15
1456877,1060919,2021-04-22,Assembly,"Do pass and be re-referred to the Committee on [Appropriations]",5,2,0,0,7
1456878,1073411,2021-05-05,Assembly,"Do pass",8,0,0,0,8
1456881,1064024,2021-04-26,Assembly,"Do pass and be re-referred to the Committee on [Appropriations]",11,4,0,0,15
1456882,1051968,2021-04-13,Assembly,"Do pass and be re-referred to the Committee on [Privacy and Consumer Protection]",11,3,1,0,15
1456882,1060897,2021-04-22,Assembly,"Do pass and be re-referred to the Committee on [Appropriations]",9,1,1,0,11
1456882,1073385,2021-05-05,Assembly,"Do pass",13,3,0,0,16
1456882,1077600,2021-05-13,Assembly,"AB 1184 Chiu Assembly Third Reading",59,13,6,0,78
1456883,1060816,2021-04-22,Assembly,"Do pass and be re-referred to the Committee on [Appropriations]",12,0,0,0,12
1456886,1067625,2021-04-29,Assembly,"Do pass as amended and be re-referred to the Committee on [Appropriations]",5,1,2,0,8
1456888,1064033,2021-04-26,Assembly,"Do pass and be re-referred to the Committee on [Appropriations] with recommendation: To Consent Calendar",15,0,0,0,15
1456889,1059271,2021-04-20,Assembly,"Do pass and be re-referred to the Committee on [Appropriations]",8,0,0,0,8
1456890,1060923,2021-04-22,Assembly,"Do pass and be re-referred to the Committee on [Appropriations]",5,2,0,0,7
1456892,1051915,2021-04-13,Assembly,"Do pass and be re-referred to the Committee on [Judiciary]",17,0,2,0,19
1456892,1064076,2021-04-27,Assembly,"Do pass as amended and be re-referred to the Committee on [Appropriations]",11,0,0,0,11
1456893,1059291,2021-04-21,Assembly,"Do pass and be re-referred to the Committee on [Local Government]",6,0,3,0,9
1456893,1065201,2021-04-28,Assembly,"Do pass and be re-referred to the Committee on [Appropriations]",6,1,1,0,8
1456894,1065150,2021-04-28,Assembly,"Do pass and be re-referred to the Committee on [Appropriations] with recommendation: To Consent Calendar",8,0,0,0,8
1456894,1073446,2021-05-05,Assembly,"Do pass",15,1,0,0,16
1456898,1047567,2021-04-07,Assembly,"Do pass",6,1,2,0,9
1456898,1060871,2021-04-22,Assembly,"AB 1200 Ting Assembly Third Reading",48,14,17,0,79
1456899,1036474,2021-03-24,Assembly,"Do pass as amended and be re-referred to the Committee on [Appropriations]",10,0,1,0,11
1456900,1057678,2021-04-19,Assembly,"Do pass. To Consent Calendar",6,0,1,0,7
1456901,1046122,2021-04-05,Assembly,"Do pass as amended",8,2,1,0,11
1456901,1054650,2021-04-15,Assembly,"AB 1203 Burke Assembly Third Reading",59,14,5,0,78
1456902,1073443,2021-05-05,Assembly,"Do pass as amended",8,0,0,0,8
1456903,1064043,2021-04-26,Assembly,"Do pass and be re-referred to the Committee on [Appropriations] with recommendation: To Consent Calendar",15,0,0,0,15
1456905,1045025,2021-04-05,Assembly,"Do pass. To Consent Calendar",7,0,0,0,7
1456906,1051894,2021-04-12,Assembly,"Do pass and be re-referred to the Committee on [Appropriations]",15,0,0,0,15
1456906,1073393,2021-05-05,Assembly,"Do pass. To Consent Calendar",16,0,0,0,16
1456906,1077531,2021-05-13,Assembly,"AB 974 Luz Rivas Consent Calendar Second Day Regular Session",75,0,3,0,78
1456907,1054740,2021-04-15,Assembly,"Do pass as amended, and be re-referred to the Committee on [Appropriations] with recommendation: To Consent Calendar",7,0,0,0,7
1456907,1073412,2021-05-05,Assembly,"Do pass as amended. To Consent Calendar",16,0,0,0,16
1456908,1036443,2021-03-24,Assembly,"Do pass and be re-referred to the Committee on [Appropriations]",8,0,3,0,11
1456909,1054707,2021-04-15,Assembly,"Do pass and be re-referred to the Committee on [Human Services]",8,0,0,0,8
1456909,1059277,2021-04-21,Assembly,"Do pass and be re-referred to the Committee on [Appropriations] with recommendation: To Consent Calendar",8,0,0,0,8
1456910,1068212,2021-05-03,Assembly,"Do pass as amended",5,2,1,0,8
1456911,1064094,2021-04-26,Assembly,"Do pass and be re-referred to the Committee on [Appropriations]",9,5,1,0,15
1456912,1066677,2021-04-29,Assembly,"Do pass and be re-referred to the Committee on [Appropriations] with recommendation: To Consent Calendar",13,0,0,0,13
1456913,1053434,2021-04-14,Assembly,"Do pass as amended and be re-referred to the Committee on [Appropriations]",11,0,0,0,11
1456915,1060828,2021-04-22,Assembly,"Do pass and be re-referred to the Committee on [Appropriations]",5,1,1,0,7
1456915,1073387,2021-05-05,Assembly,"Do pass",12,3,1,0,16
1456915,1077594,2021-05-13,Assembly,"AB 983 Eduardo Garcia Assembly Third Reading",57,13,8,0,78
1456916,1044943,2021-04-05,Assembly,"Do pass as amended and be re-referred to the Committee on [Privacy and Consumer Protection]",12,0,3,0,15
1456916,1060988,2021-04-22,Assembly,"Do pass as amended and be re-referred to the Committee on [Appropriations]",9,0,2,0,11
1456920,1057697,2021-04-20,Assembly,"Do pass and be re-referred to the Committee on [Communications and Conveyance]",11,2,2,0,15
1456920,1065239,2021-04-28,Assembly,"Do pass and be re-referred to the Committee on [Appropriations]",10,0,3,0,13
1456921,1054738,2021-04-15,Assembly,"Do pass and be re-referred to the Committee on [Local Government]",6,0,2,0,8
1456921,1065107,2021-04-28,Assembly,"Do pass as amended and be re-referred to the Committee on [Appropriations]",8,0,0,0,8
1456922,1059180,2021-04-20,Assembly,"Do pass as amended and be re-referred to the Committee on [Appropriations]",6,1,1,0,8
1456924,1045020,2021-04-05,Assembly,"Do pass and be re-referred to the Committee on [Natural Resources] with recommendation: To Consent Calendar",14,0,1,0,15
1456924,1065247,2021-04-28,Assembly,"Do pass and be re-referred to the Committee on [Appropriations]",11,0,0,0,11
1456924,1076969,2021-05-12,Assembly,"Do pass. To Consent Calendar",16,0,0,0,16
1456925,1046135,2021-04-06,Assembly,"Do pass and be re-referred to the Committee on [Appropriations] with recommendation: To Consent Calendar",11,0,0,0,11
1456927,1060855,2021-04-22,Assembly,"Do pass and be re-referred to the Committee on [Appropriations]",5,2,0,0,7
1456930,1047434,2021-04-06,Assembly,"Do pass and be re-referred to the Committee on [Appropriations] with recommendation: To Consent Calendar",8,0,0,0,8
1456932,1016246,2021-02-25,Assembly,"Be adopted. To Consent Calendar",11,0,1,0,12
1456932,1022347,2021-03-04,Assembly,"ACR 31 Grayson Consent Calendar Second Day",72,0,7,0,79
1456932,1037802,2021-03-25,Senate,"Special Consent ACR31",38,0,2,0,40
1456933,1051923,2021-04-12,Assembly,"Be adopted. To Consent Calendar",15,0,0,0,15
1456933,1054696,2021-04-15,Assembly,"ACR 32 Megan Dahle Consent Calendar Second Day Regular Session",75,0,3,0,78
1456934,1021145,2021-03-03,Senate,"Do pass, but first be re-referred to the Committee on [Appropriations]",5,0,0,0,5
1456935,1053436,2021-04-14,Senate,"Do pass, but first be re-referred to the Committee on [Appropriations]",6,1,0,0,7
1456935,1068226,2021-05-03,Senate,"Placed on suspense file",6,0,1,0,7
1456936,1030806,2021-03-17,Senate,"Do pass as amended, but first amend, and re-refer to the Committee on [Appropriations] with the recommendation: To Consent Calendar",10,0,1,0,11
1456936,1075264,2021-05-10,Senate,"Consent Calendar SB541",37,0,3,0,40
1456937,1052008,2021-04-13,Senate,"Do pass as amended, but first amend, and re-refer to the Committee on [Governance and Finance]",14,0,3,0,17
1456937,1074179,2021-05-06,Senate,"Do pass, but first be re-referred to the Committee on [Appropriations]",4,1,0,0,5
1456938,1025107,2021-03-09,Senate,"Do pass as amended, but first amend, and re-refer to the Committee on [Appropriations]",13,0,1,0,14
1456938,1033598,2021-03-22,Senate,"Placed on suspense file",7,0,0,0,7
1456939,1033650,2021-03-22,Senate,"Do pass, but first be re-referred to the Committee on [Appropriations]",13,0,1,0,14
1456939,1045012,2021-04-05,Senate,"Placed on suspense file",7,0,0,0,7
1456940,1053568,2021-04-14,Senate,"Do pass as amended, but first amend, and re-refer to the Committee on [Appropriations]",7,0,0,0,7
1456940,1068283,2021-05-03,Senate,"Placed on suspense file",6,0,1,0,7
1456941,1050836,2021-04-12,Senate,"Do pass as amended, but first amend, and re-refer to the Committee on [Human Services]",14,0,0,0,14
1456941,1057706,2021-04-20,Senate,"Do pass, but first be re-referred to the Committee on [Appropriations]",5,0,0,0,5
1456941,1075384,2021-05-10,Senate,"Placed on suspense file",7,0,0,0,7
1456942,1031916,2021-03-18,Senate,"Do pass, but first be re-referred to the Committee on [Education]",5,0,0,0,5
1456942,1047576,2021-04-07,Senate,"Do pass, but first be re-referred to the Committee on [Appropriations] with the recommendation: To Consent Calendar",7,0,0,0,7
1456942,1056397,2021-04-19,Senate,"Placed on suspense file",7,0,0,0,7
1456943,1051960,2021-04-13,Senate,"Do pass",16,0,1,0,17
1456943,1068165,2021-05-03,Senate,"Senate 3rd Reading SB548 Eggman et al",36,0,4,0,40
1456944,1046222,2021-04-05,Senate,"Do pass, but first be re-referred to the Committee on [Human Services] with the recommendation: To Consent Calendar",5,0,0,0,5
1456944,1057723,2021-04-20,Senate,"Do pass and be ordered to the Consent Calendar",5,0,0,0,5
1456944,1066784,2021-04-29,Senate,"Consent Calendar SB549 Jones Urgency Clause",36,0,4,0,40
1456945,1056332,2021-04-19,Senate,"Do pass, but first be re-referred to the Committee on [Judiciary]",5,0,0,0,5
1456945,1065226,2021-04-27,Senate,"Do pass, but first be re-referred to the Committee on [Appropriations]",9,2,0,0,11
1456945,1075334,2021-05-10,Senate,"Placed on suspense file",7,0,0,0,7
1456946,1046132,2021-04-06,Senate,"Do pass as amended, but first amend, and re-refer to the Committee on [Transportation]",10,3,2,0,15
1456946,1064068,2021-04-27,Senate,"Do pass as amended, but first amend, and re-refer to the Committee on [Appropriations]",14,2,1,0,17
1456947,1051890,2021-04-13,Senate,"Do pass, but first be re-referred to the Committee on [Governance and Finance]",8,0,1,0,9
1456947,1060870,2021-04-22,Senate,"Do pass as amended, but first amend, and re-refer to the Committee on [Appropriations]",5,0,0,0,5
1456947,1075277,2021-05-10,Senate,"Placed on suspense file",7,0,0,0,7
1456948,1074191,2021-05-06,Senate,"Do pass as amended, but first amend, and re-refer to the Committee on [Appropriations]",5,0,0,0,5
1456950,1037809,2021-03-25,Senate,"Do pass, but first be re-referred to the Committee on [Judiciary]",5,0,0,0,5
1456950,1059233,2021-04-20,Senate,"Do pass, but first be re-referred to the Committee on [Appropriations]",11,0,0,0,11
1456950,1068206,2021-05-03,Senate,"Placed on suspense file",6,0,1,0,7
1456951,1056384,2021-04-19,Senate,"Do pass, but first be re-referred to the Committee on [Rules]",11,1,2,0,14
1456951,1060892,2021-04-22,Senate,"Do pass as amended, but first amend, and re-refer to the Committee on [Appropriations]",4,1,0,0,5
1456951,1077548,2021-05-13,Senate,"Senate 3rd Reading SB556 Dodd et al",31,2,7,0,40
1456952,1050761,2021-04-12,Senate,"Do pass, but first be re-referred to the Committee on [Appropriations] with the recommendation: To Consent Calendar",7,0,0,0,7
1456952,1056387,2021-04-19,Senate,"Placed on suspense file",7,0,0,0,7
1456953,1053474,2021-04-14,Senate,"Do pass as amended, but first amend, and re-refer to the Committee on [Human Services]",10,0,1,0,11
1456953,1057726,2021-04-20,Senate,"Do pass as amended, but first amend, and re-refer to the Committee on [Appropriations]",5,0,0,0,5
1456954,1064083,2021-04-27,Senate,"Do pass, but first be re-referred to the Committee on [Appropriations]",6,0,3,0,9
1456954,1075369,2021-05-10,Senate,"Placed on suspense file",7,0,0,0,7
1456955,1062768,2021-04-26,Senate,"Do pass as amended, but first amend, and re-refer to the Committee on [Appropriations]",11,0,3,0,14
1456956,1057643,2021-04-20,Senate,"Do pass, but first be re-referred to the Committee on [Appropriations]",15,0,0,0,15
1456956,1075345,2021-05-10,Senate,"Senate 3rd Reading SB561 Dodd",37,0,3,0,40
1456957,1046088,2021-04-06,Senate,"Do pass, but first be re-referred to the Committee on [Health]",5,0,0,0,5
1456957,1059142,2021-04-21,Senate,"Do pass, but first be re-referred to the Committee on [Appropriations]",11,0,0,0,11
1456957,1075311,2021-05-10,Senate,"Placed on suspense file",7,0,0,0,7
1456958,1049009,2021-04-08,Senate,"Do pass as amended, but first amend, and re-refer to the Committee on [Housing]",5,0,0,0,5
1456958,1066788,2021-04-29,Senate,"Do pass as amended, but first amend, and re-refer to the Committee on [Appropriations]",7,2,0,0,9
1456959,1030803,2021-03-17,Senate,"Do pass as amended, but first amend, and re-refer to the Committee on [Appropriations] with the recommendation: To Consent Calendar",10,0,1,0,11
1456959,1060889,2021-04-22,Senate,"Consent Calendar SB564",38,0,2,0,40
1456960,1047485,2021-04-07,Senate,"Do pass, but first be re-referred to the Committee on [Judiciary] with the recommendation: To Consent Calendar",11,0,0,0,11
1456960,1053467,2021-04-13,Senate,"Do pass, but first be re-referred to the Committee on [Appropriations] with the recommendation: To Consent Calendar",10,0,1,0,11
1456960,1068191,2021-05-03,Senate,"Placed on suspense file",6,0,1,0,7
1456961,1026104,2021-03-10,Senate,"Do pass, but first be re-referred to the Committee on [Appropriations]",4,1,2,0,7
1456961,1033676,2021-03-22,Senate,"Placed on suspense file",7,0,0,0,7
1456962,1051918,2021-04-13,Senate,"Do pass as amended, but first amend, and re-refer to the Committee on [Appropriations]",4,1,0,0,5
1456962,1068210,2021-05-03,Senate,"Placed on suspense file",6,0,1,0,7
1456963,1065115,2021-04-28,Senate,"Do pass as amended, but first amend, and re-refer to the Committee on [Appropriations]",9,2,0,0,11
1456964,1065119,2021-04-27,Senate,"Do pass, but first be re-referred to the Committee on [Appropriations] with the recommendation: To Consent Calendar",11,0,0,0,11
1456964,1075377,2021-05-10,Senate,"Placed on suspense file",7,0,0,0,7
1456965,1063997,2021-04-27,Senate,"Do pass as amended, and be ordered to the Consent Calendar",15,0,2,0,17
1456967,1046219,2021-04-05,Senate,"Do pass, but first be re-referred to the Committee on [Judiciary]",5,0,0,0,5
1456967,1059332,2021-04-20,Senate,"Do pass, but first be re-referred to the Committee on [Appropriations]",10,0,1,0,11
1456967,1075367,2021-05-10,Senate,"Senate 3rd Reading SB572 Hertzberg",36,0,4,0,40
1456969,1027166,2021-03-11,Senate,"Do pass, but first be re-referred to the Committee on [Appropriations] with the recommendation: To Consent Calendar",5,0,0,0,5
1456969,1037824,2021-03-25,Senate,"Consent Calendar SB574",38,0,2,0,40
1456970,1066785,2021-04-29,Senate,"Do pass, but first be re-referred to the Committee on [Appropriations]",5,2,0,0,7
1456971,1046224,2021-04-06,Senate,"Do pass as amended, but first amend, and re-refer to the Committee on [Appropriations]",10,1,4,0,15
1456971,1075275,2021-05-10,Senate,"Senate 3rd Reading SB576 Archuleta",30,2,8,0,40
1456972,1059210,2021-04-21,Senate,"Do pass, but first be re-referred to the Committee on [Appropriations] with the recommendation: To Consent Calendar",9,0,0,0,9
1456972,1077580,2021-05-13,Senate,"Consent Calendar SB577",38,0,2,0,40
1456973,1029598,2021-03-16,Senate,"Do pass, but first be re-referred to the Committee on [Appropriations] with the recommendation: To Consent Calendar",11,0,0,0,11
1456973,1048957,2021-04-08,Senate,"Consent Calendar SB578",38,0,2,0,40
1456975,1052006,2021-04-13,Senate,"Do pass, but first be re-referred to the Committee on [Appropriations]",16,0,1,0,17
1456975,1068192,2021-05-03,Senate,"Placed on suspense file",6,0,1,0,7
1456976,1054672,2021-04-15,Senate,"Do pass, but first be re-referred to the Committee on [Appropriations] with the recommendation: To Consent Calendar",9,0,0,0,9
1456976,1075244,2021-05-10,Senate,"Consent Calendar SB581",37,0,3,0,40
1456977,1050834,2021-04-12,Senate,"Do pass, but first be re-referred to the Committee on [Natural Resources and Water]",5,2,0,0,7
1456977,1064172,2021-04-27,Senate,"Do pass, but first be re-referred to the Committee on [Appropriations]",7,2,0,0,9
1456977,1075313,2021-05-10,Senate,"Placed on suspense file",7,0,0,0,7
1456978,1050780,2021-04-12,Senate,"Do pass, but first be re-referred to the Committee on [Rules]",4,1,0,0,5
1456978,1064073,2021-04-27,Senate,"Do pass as amended, but first amend, and re-refer to the Committee on [Appropriations]",13,3,1,0,17
1456978,1075298,2021-05-10,Senate,"Placed on suspense file",7,0,0,0,7
1456979,1035261,2021-03-23,Senate,"Do pass, but first be re-referred to the Committee on [Appropriations]",5,0,0,0,5
1456979,1068255,2021-05-03,Senate,"Senate 3rd Reading SB584 Jones",36,0,4,0,40
1456981,1051984,2021-04-13,Senate,"Do pass, but first be re-referred to the Committee on [Appropriations]",4,1,0,0,5
1456981,1068189,2021-05-03,Senate,"Placed on suspense file",6,0,1,0,7
1456984,1050809,2021-04-12,Senate,"Do pass, but first be re-referred to the Committee on [Transportation]",14,0,0,0,14
1456984,1064132,2021-04-27,Senate,"Do pass, but first be re-referred to the Committee on [Appropriations]",17,0,0,0,17
1456984,1075396,2021-05-10,Senate,"Placed on suspense file",7,0,0,0,7
1456985,1062757,2021-04-26,Senate,"Do pass as amended",5,0,0,0,5
1456985,1074198,2021-05-06,Senate,"Senate 3rd Reading SB590 Allen",37,0,3,0,40
1456986,1059198,2021-04-20,Senate,"Do pass, but first be re-referred to the Committee on [Housing] with the recommendation: To Consent Calendar",11,0,0,0,11
1456986,1066775,2021-04-29,Senate,"Do pass as amended, and be ordered to the Consent Calendar",9,0,0,0,9
1456986,1075249,2021-05-10,Senate,"Consent Calendar SB591",37,0,3,0,40
1456987,1054659,2021-04-15,Senate,"Do pass as amended, but first amend, and re-refer to the Committee on [Appropriations]",8,0,1,0,9
1456987,1075320,2021-05-10,Senate,"Placed on suspense file",7,0,0,0,7
1456988,1053446,2021-04-14,Senate,"Do pass, but first be re-referred to the Committee on [Appropriations]",7,0,0,0,7
1456988,1068243,2021-05-03,Senate,"Placed on suspense file",6,0,1,0,7
1456989,1050782,2021-04-12,Senate,"Do pass, but first be re-referred to the Committee on [Governance and Finance] with the recommendation: To Consent Calendar",5,0,0,0,5
1456989,1074134,2021-05-06,Senate,"Do pass and be ordered to the Consent Calendar",5,0,0,0,5
1456989,1077549,2021-05-13,Senate,"Consent Calendar SB594 Glazer Urgency Clause",38,0,2,0,40
1456991,1066733,2021-04-29,Senate,"Do pass, but first be re-referred to the Committee on [Appropriations]",5,1,1,0,7
1456993,1046139,2021-04-05,Senate,"Do pass, but first be re-referred to the Committee on [Judiciary]",5,0,0,0,5
1456993,1059174,2021-04-20,Senate,"Do pass, but first be re-referred to the Committee on [Appropriations]",9,2,0,0,11
1456993,1068185,2021-05-03,Senate,"Placed on suspense file",6,0,1,0,7
1456994,1056363,2021-04-19,Senate,"Do pass, but first be re-referred to the Committee on [Appropriations] with the recommendation: To Consent Calendar",14,0,0,0,14
1456994,1075308,2021-05-10,Senate,"Consent Calendar SB599",37,0,3,0,40
1456996,1074170,2021-05-06,Senate,"Do pass, but first be re-referred to the Committee on [Appropriations]",4,0,1,0,5
1456997,1053462,2021-04-13,Senate,"Do pass, but first be re-referred to the Committee on [Appropriations] with the recommendation: To Consent Calendar",10,0,1,0,11
1456997,1068158,2021-05-03,Senate,"Placed on suspense file",6,0,1,0,7
1456998,1044993,2021-04-05,Senate,"Do pass, but first be re-referred to the Committee on [Governance and Finance]",9,0,5,0,14
1456998,1054647,2021-04-15,Senate,"Do pass as amended, but first amend, and re-refer to the Committee on [Appropriations]",5,0,0,0,5
1456998,1068269,2021-05-03,Senate,"Placed on suspense file",6,0,1,0,7
1456999,1054602,2021-04-15,Senate,"Do pass, but first be re-referred to the Committee on [Appropriations]",9,0,0,0,9
1456999,1068196,2021-05-03,Senate,"Placed on suspense file",6,0,1,0,7
1457000,1053563,2021-04-14,Senate,"Do pass as amended, but first amend, and re-refer to the Committee on [Judiciary]",10,0,1,0,11
1457000,1065133,2021-04-27,Senate,"Do pass as amended, but first amend, and re-refer to the Committee on [Appropriations]",9,0,2,0,11
1457000,1075322,2021-05-10,Senate,"Placed on suspense file",7,0,0,0,7
1457001,1038711,2021-03-22,Senate,"Do pass, but first be re-referred to the Committee on [Judiciary]",4,1,0,0,5
1457001,1047541,2021-04-06,Senate,"Do pass as amended, but first amend, and re-refer to the Committee on [Appropriations]",7,0,4,0,11
1457001,1047542,2021-04-06,Senate,"[04-07-2021] set for [First] hearing: Reconsideration of favorable vote granted",11,0,0,0,11
1457001,1047543,2021-04-06,Senate,"Do pass as amended, but first amend, and re-refer to the Committee on [Appropriations]",9,2,0,0,11
1457001,1056348,2021-04-19,Senate,"Placed on suspense file",7,0,0,0,7
1457002,1056434,2021-04-19,Senate,"Do pass, but first be re-referred to the Committee on [Appropriations]",13,0,1,0,14
1457004,1046169,2021-04-06,Senate,"Do pass as amended, but first amend, and re-refer to the Committee on [Appropriations]",5,0,0,0,5
1457004,1068237,2021-05-03,Senate,"Placed on suspense file",6,0,1,0,7
1457005,1074143,2021-05-06,Senate,"Do pass, but first be re-referred to the Committee on [Appropriations]",5,0,0,0,5
1457006,1074149,2021-05-06,Senate,"Do pass as amended, but first amend, and re-refer to the Committee on [Appropriations]",5,0,0,0,5
1457007,1062793,2021-04-26,Senate,"Do pass as amended, but first amend, and re-refer to the Committee on [Appropriations]",11,1,2,0,14
1457009,1030800,2021-03-17,Senate,"Do pass, but first be re-referred to the Committee on [Appropriations]",7,0,0,0,7
1457009,1050771,2021-04-12,Senate,"Senate 3rd Reading SB614 Archuleta et al",39,0,1,0,40
1457011,1065231,2021-04-28,Senate,"Do pass as amended, and be ordered to the Consent Calendar",7,0,0,0,7
1457011,1075236,2021-05-10,Senate,"Consent Calendar SB616",37,0,3,0,40
1457012,1048877,2021-04-08,Senate,"Do pass as amended, but first amend, and re-refer to the Committee on [Energy, Utilities and Communications]",4,0,1,0,5
1457012,1062765,2021-04-26,Senate,"Do pass as amended, but first amend, and re-refer to the Committee on [Appropriations]",12,2,0,0,14
1457014,1066693,2021-04-29,Senate,"Do pass, but first be re-referred to the Committee on [Appropriations]",7,0,0,0,7
1457016,1054611,2021-04-15,Senate,"Do pass, but first be re-referred to the Committee on [Governance and Finance]",6,0,3,0,9
1457017,1046171,2021-04-06,Senate,"Do pass, but first be re-referred to the Committee on [Education] with the recommendation: To Consent Calendar",5,0,0,0,5
1457018,1051948,2021-04-13,Senate,"Do pass, but first be re-referred to the Committee on [Judiciary]",15,0,2,0,17
1457019,1054628,2021-04-15,Senate,"Do pass as amended, but first amend, and re-refer to the Committee on [Environmental Quality]",9,0,0,0,9
1457019,1066827,2021-04-29,Senate,"Do pass, but first be re-referred to the Committee on [Appropriations] with the recommendation: To Consent Calendar",7,0,0,0,7
1457020,1044955,2021-04-05,Senate,"Do pass, but first be re-referred to the Committee on [Appropriations]",14,0,0,0,14
1457020,1056403,2021-04-19,Senate,"Placed on suspense file",7,0,0,0,7
1457021,1064035,2021-04-27,Senate,"Do pass as amended, but first amend, and re-refer to the Committee on [Appropriations]",9,0,0,0,9
1457023,1051966,2021-04-13,Senate,"Be adopted, but first be re-referred to the Committee on [Appropriations] with recommendation: To Consent Calendar",15,0,2,0,17
1457023,1075259,2021-05-10,Senate,"Consent Calendar SCR14",37,0,3,0,40
1457024,1036517,2021-03-24,Senate,"Be adopted. Ordered to third reading",4,2,1,0,7
1457024,1062762,2021-04-26,Senate,"Senate 3rd Reading SJR1 Allen",29,6,5,0,40
1458756,1051932,2021-04-13,Assembly,"Do pass as amended and be re-referred to the Committee on [Appropriations]",11,3,1,0,15
1458759,1057641,2021-04-20,Assembly,"Do pass as amended and be re-referred to the Committee on [Appropriations]",13,0,2,0,15
1458760,1035152,2021-03-23,Assembly,"Do pass and be re-referred to the Committee on [Appropriations] with recommendation: To Consent Calendar",11,0,0,0,11
1458762,1059163,2021-04-20,Assembly,"Do pass",6,2,0,0,8
1458762,1062744,2021-04-26,Assembly,"AB 1210 Ting Assembly Third Reading",56,17,5,0,78
1458766,1064092,2021-04-27,Assembly,"Do pass as amended and be re-referred to the Committee on [Appropriations]",14,0,1,0,15
1458767,1048993,2021-04-08,Assembly,"Do pass and be re-referred to the Committee on [Appropriations]",10,0,2,0,12
1458768,1060882,2021-04-22,Assembly,"Do pass as amended and be re-referred to the Committee on [Appropriations]",12,0,0,0,12
1458769,1057677,2021-04-19,Assembly,"Do pass. To Consent Calendar",6,0,1,0,7
1458770,1056358,2021-04-19,Assembly,"Do pass and be re-referred to the Committee on [Appropriations]",8,5,2,0,15
1458771,1051889,2021-04-12,Assembly,"Do pass and be re-referred to the Committee on [Appropriations]",9,0,2,0,11
1458772,1067598,2021-04-29,Assembly,"Do pass as amended and be re-referred to the Committee on [Appropriations]",8,0,0,0,8
1458772,1076970,2021-05-12,Assembly,"Do pass. To Consent Calendar",16,0,0,0,16
1458773,1048924,2021-04-08,Assembly,"Do pass and be re-referred to the Committee on [Judiciary] with recommendation: To Consent Calendar",11,0,0,0,11
1458773,1072226,2021-05-04,Assembly,"Do pass as amended. To Consent Calendar",11,0,0,0,11
1458774,1057705,2021-04-20,Assembly,"Do pass and be re-referred to the Committee on [Appropriations] with recommendation: To Consent Calendar",19,0,0,0,19
1458774,1065242,2021-04-28,Assembly,"Do pass. To Consent Calendar",16,0,0,0,16
1458774,1074121,2021-05-06,Assembly,"AB 1222 Chen Consent Calendar Second Day Regular Session",77,0,1,0,78
1458775,1047573,2021-04-06,Assembly,"Do pass and be re-referred to the Committee on [Revenue and Taxation]",6,2,0,0,8
1458775,1064077,2021-04-26,Assembly,"Do pass as amended and be re-referred to the Committee on [Appropriations]",6,4,1,0,11
1458776,1059187,2021-04-20,Assembly,"Do pass and be re-referred to the Committee on [Appropriations]",5,2,1,0,8
1458777,1059205,2021-04-20,Assembly,"Do pass and be re-referred to the Committee on [Appropriations] with recommendation: To Consent Calendar",8,0,0,0,8
1458780,1059173,2021-04-20,Assembly,"Do pass as amended and be re-referred to the Committee on [Appropriations]",6,2,0,0,8
1458781,1044992,2021-04-05,Assembly,"Do pass and be re-referred to the Committee on [Appropriations]",7,0,0,0,7
1458781,1046131,2021-04-05,Assembly,"Do pass and be re-referred to the Committee on [Health]",7,0,0,0,7
1458781,1064037,2021-04-27,Assembly,"Do pass and be re-referred to the Committee on [Appropriations]",15,0,0,0,15
1458788,1065255,2021-04-27,Assembly,"Do pass as amended and be re-referred to the Committee on [Appropriations]",19,0,0,0,19
1458789,1053573,2021-04-13,Assembly,"Do pass and be re-referred to the Committee on [Privacy and Consumer Protection]",6,2,0,0,8
1458789,1060968,2021-04-22,Assembly,"Do pass as amended and be re-referred to the Committee on [Appropriations]",8,2,1,0,11
1458790,1064034,2021-04-26,Assembly,"Do pass and be re-referred to the Committee on [Appropriations]",12,2,1,0,15
1458794,1060917,2021-04-22,Assembly,"Do pass as amended and be re-referred to the Committee on [Appropriations]",20,0,2,0,22
1458795,1072275,2021-05-04,Assembly,"Do pass",11,0,0,0,11
1458797,1065291,2021-04-27,Assembly,"Do pass and be re-referred to the Committee on [Appropriations]",6,1,1,0,8
1458799,1059189,2021-04-20,Assembly,"Do pass and be re-referred to the Committee on [Appropriations] with recommendation: To Consent Calendar",8,0,0,0,8
1458802,1047476,2021-04-07,Assembly,"Do pass and be re-referred to the Committee on [Utilities and Energy]",9,0,0,0,9
1458802,1059196,2021-04-21,Assembly,"Do pass and be re-referred to the Committee on [Appropriations] with recommendation: To Consent Calendar",15,0,0,0,15
1458804,1035186,2021-03-23,Assembly,"Do pass and be re-referred to the Committee on [Privacy and Consumer Protection]",11,2,2,0,15
1458804,1060886,2021-04-22,Assembly,"Do pass and be re-referred to the Committee on [Appropriations]",8,1,2,0,11
1458807,1053438,2021-04-14,Assembly,"Do pass as amended and be re-referred to the Committee on [Appropriations]",8,1,2,0,11
1458809,1054706,2021-04-14,Assembly,"Do pass and be re-referred to the Committee on [Appropriations]",12,0,1,0,13
1458811,1065212,2021-04-27,Assembly,"Do pass and be re-referred to the Committee on [Appropriations]",6,2,0,0,8
1458811,1076971,2021-05-12,Assembly,"Do pass",12,4,0,0,16
1458812,1065095,2021-04-28,Assembly,"Do pass and be re-referred to the Committee on [Appropriations]",8,2,1,0,11
1458812,1076924,2021-05-12,Assembly,"Do pass",16,0,0,0,16
1458813,1053487,2021-04-14,Assembly,"Do pass and be re-referred to the Committee on [Appropriations] with recommendation: To Consent Calendar",11,0,0,0,11
1458814,1060813,2021-04-22,Assembly,"Do pass and be re-referred to the Committee on [Appropriations]",10,0,1,0,11
1458814,1073338,2021-05-05,Assembly,"Do pass",16,0,0,0,16
1458814,1075375,2021-05-10,Assembly,"AB 1262 Cunningham Assembly Third Reading",63,0,15,0,78
1458816,1051884,2021-04-13,Assembly,"Do pass and be re-referred to the Committee on [Appropriations] with recommendation: To Consent Calendar",15,0,0,0,15
1458819,1060860,2021-04-22,Assembly,"Do pass as amended and be re-referred to the Committee on [Appropriations]",21,0,1,0,22
1458819,1076957,2021-05-12,Assembly,"Do pass. To Consent Calendar",16,0,0,0,16
1458821,1048937,2021-04-08,Assembly,"Do pass as amended and be re-referred to the Committee on [Appropriations]",11,1,0,0,12
1458823,1054632,2021-04-14,Assembly,"Do pass as amended and be re-referred to the Committee on [Housing and Community Development]",6,1,1,0,8
1458825,1060977,2021-04-22,Assembly,"Do pass and be re-referred to the Committee on [Appropriations] with recommendation: To Consent Calendar",7,0,0,0,7
1458825,1073419,2021-05-05,Assembly,"Do pass. To Consent Calendar",16,0,0,0,16
1458825,1077528,2021-05-13,Assembly,"AB 1273 Rodriguez Consent Calendar Second Day Regular Session",75,0,3,0,78
1458827,1048883,2021-04-08,Assembly,"Do pass and be re-referred to the Committee on [Appropriations]",22,0,0,0,22
1458828,1036468,2021-03-24,Assembly,"Do pass as amended and be re-referred to the Committee on [Appropriations]",8,0,3,0,11
1458830,1051972,2021-04-13,Assembly,"Do pass as amended and be re-referred to the Committee on [Appropriations]",13,0,6,0,19
1458830,1065179,2021-04-28,Assembly,"Do pass",12,0,4,0,16
1458830,1068199,2021-05-03,Assembly,"AB 1278 Nazarian Assembly Third Reading",54,9,15,0,78
1458831,1064057,2021-04-26,Assembly,"Do pass and be re-referred to the Committee on [Appropriations] with recommendation: To Consent Calendar",15,0,0,0,15
1458832,1064026,2021-04-27,Assembly,"Do pass and be re-referred to the Committee on [Appropriations]",15,0,0,0,15
1458832,1073367,2021-05-05,Assembly,"Do pass. To Consent Calendar",16,0,0,0,16
1458832,1077605,2021-05-13,Assembly,"AB 1280 Irwin Consent Calendar Second Day Regular Session",75,0,3,0,78
1458833,1065171,2021-04-27,Assembly,"Do pass as amended",8,0,0,0,8
1458834,1057735,2021-04-20,Assembly,"Do pass and be re-referred to the Committee on [Agriculture]",19,0,0,0,19
1458834,1066678,2021-04-29,Assembly,"Do pass and be re-referred to the Committee on [Appropriations]",9,1,1,0,11
1458835,1059260,2021-04-21,Assembly,"Do pass and be re-referred to the Committee on [Appropriations] with recommendation: To Consent Calendar",8,0,0,0,8
1458835,1073410,2021-05-05,Assembly,"Do pass. To Consent Calendar",16,0,0,0,16
1458835,1077541,2021-05-13,Assembly,"AB 1283 Stone Consent Calendar Second Day Regular Session",75,0,3,0,78
1458838,1064056,2021-04-27,Assembly,"Do pass and be re-referred to the Committee on [Appropriations] with recommendation: To Consent Calendar",15,0,0,0,15
1458839,1046123,2021-04-06,Assembly,"Do pass and be re-referred to the Committee on [Judiciary]",18,0,1,0,19
1458839,1057642,2021-04-20,Assembly,"Do pass as amended and be re-referred to the Committee on [Appropriations]",9,1,1,0,11
1458842,1048922,2021-04-08,Assembly,"Do pass and be re-referred to the Committee on [Appropriations]",12,0,0,0,12
1458842,1059155,2021-04-21,Assembly,"Do pass. To Consent Calendar",14,0,2,0,16
1458842,1066822,2021-04-29,Assembly,"AB 1290 Lee Consent Calendar Second Day Regular Session",77,0,1,0,78
1458843,1048939,2021-04-08,Assembly,"Do pass and be re-referred to the Committee on [Appropriations] with recommendation: To Consent Calendar",22,0,0,0,22
1458843,1059177,2021-04-21,Assembly,"Do pass. To Consent Calendar",14,0,2,0,16
1458843,1066734,2021-04-29,Assembly,"AB 1291 Frazier Consent Calendar Second Day Regular Session",77,0,1,0,78
1458845,1054636,2021-04-15,Assembly,"Do pass and be re-referred to the Committee on [Appropriations]",7,0,0,0,7
1458845,1073352,2021-05-05,Assembly,"Do pass",16,0,0,0,16
1458845,1077567,2021-05-13,Assembly,"AB 1293 Cooley Assembly Third Reading",75,0,3,0,78
1458846,1047477,2021-04-07,Assembly,"Do pass and be re-referred to the Committee on [Education] with recommendation: To Consent Calendar",8,0,0,0,8
1458846,1065269,2021-04-28,Assembly,"Do pass and be re-referred to the Committee on [Appropriations] with recommendation: To Consent Calendar",7,0,0,0,7
1458849,1051928,2021-04-13,Assembly,"Do pass as amended and be re-referred to the Committee on [Housing and Community Development]",7,0,0,0,7
1458849,1067613,2021-04-29,Assembly,"Do pass and be re-referred to the Committee on [Appropriations]",5,1,2,0,8
1458849,1076979,2021-05-12,Assembly,"Do pass",13,3,0,0,16
1458850,1047556,2021-04-07,Assembly,"Do pass and be re-referred to the Committee on [Water, Parks, and Wildlife] with recommendation: To Consent Calendar",9,0,0,0,9
1458850,1064165,2021-04-26,Assembly,"Do pass and be re-referred to the Committee on [Appropriations] with recommendation: To Consent Calendar",15,0,0,0,15
1458854,1065111,2021-04-27,Assembly,"Do pass and be re-referred to the Committee on [Appropriations]",16,2,1,0,19
1458856,1054678,2021-04-15,Assembly,"Do pass and be re-referred to the Committee on [Local Government]",6,0,2,0,8
1458856,1065270,2021-04-28,Assembly,"Do pass and be re-referred to the Committee on [Appropriations]",7,1,0,0,8
1458856,1073358,2021-05-05,Assembly,"Do pass",12,3,1,0,16
1458857,1046150,2021-04-06,Assembly,"Do pass and be re-referred to the Committee on [Appropriations] with recommendation: To Consent Calendar",18,0,1,0,19
1458857,1053576,2021-04-14,Assembly,"Do pass. To Consent Calendar",16,0,0,0,16
1458857,1060913,2021-04-22,Assembly,"AB 1305 Lackey Consent Calendar Second Day Regular Session",77,0,2,0,79
1458858,1064049,2021-04-27,Assembly,"Do pass",15,0,0,0,15
1458860,1065079,2021-04-27,Assembly,"Do pass and be re-referred to the Committee on [Appropriations]",6,2,0,0,8
1458863,1053481,2021-04-14,Assembly,"Do pass and be re-referred to the Committee on [Appropriations]",11,0,0,0,11
1458866,1065140,2021-04-28,Assembly,"Do pass. To Consent Calendar",11,0,0,0,11
1458866,1074139,2021-05-06,Assembly,"AB 1314 V. A. Consent Calendar Second Day Regular Session",77,0,1,0,78
1458867,1065163,2021-04-28,Assembly,"Do pass and be re-referred to the Committee on [Appropriations] with recommendation: To Consent Calendar",11,0,0,0,11
1458867,1073386,2021-05-05,Assembly,"Do pass. To Consent Calendar",16,0,0,0,16
1458867,1077532,2021-05-13,Assembly,"AB 1315 V. A. Consent Calendar Second Day Regular Session",75,0,3,0,78
1458868,1065114,2021-04-28,Assembly,"Do pass as amended and be re-referred to the Committee on [Appropriations]",5,2,0,0,7
1458870,1046185,2021-04-06,Assembly,"Do pass",8,0,3,0,11
1458870,1053514,2021-04-12,Assembly,"AB 1318 Stone Assembly Third Reading",57,7,14,0,78
1458871,1048968,2021-04-08,Assembly,"Do pass and be re-referred to the Committee on [Banking and Finance]",5,0,2,0,7
1458871,1066763,2021-04-29,Assembly,"Do pass and be re-referred to the Committee on [Appropriations]",9,1,2,0,12
1458872,1054657,2021-04-15,Assembly,"Do pass and be re-referred to the Committee on [Appropriations] with recommendation: To Consent Calendar",12,0,0,0,12
1458872,1065280,2021-04-28,Assembly,"Do pass. To Consent Calendar",16,0,0,0,16
1458872,1074172,2021-05-06,Assembly,"AB 1320 Bauer-Kahan Consent Calendar Second Day Regular Session",77,0,1,0,78
1458874,1054668,2021-04-14,Assembly,"Do pass as amended and be re-referred to the Committee on [Housing and Community Development]",5,3,0,0,8
1458874,1067616,2021-04-29,Assembly,"Do pass as amended",6,2,0,0,8
1458874,1075295,2021-05-10,Assembly,"AB 1322 Robert Rivas Assembly Third Reading",49,22,7,0,78
1458875,1048927,2021-04-08,Assembly,"Do pass and be re-referred to the Committee on [Accountability and Administrative Review] with recommendation: To Consent Calendar",11,0,0,0,11
1458875,1065191,2021-04-28,Assembly,"Do pass and be re-referred to the Committee on [Appropriations] with recommendation: To Consent Calendar",7,0,0,0,7
1458878,1047546,2021-04-07,Assembly,"Do pass and be re-referred to the Committee on [Higher Education] with recommendation: To Consent Calendar",8,0,0,0,8
1458878,1060859,2021-04-22,Assembly,"Do pass as amended and be re-referred to the Committee on [Appropriations]",12,0,0,0,12
1458879,1057750,2021-04-20,Assembly,"Do pass and be re-referred to the Committee on [Appropriations] with recommendation: To Consent Calendar",7,0,0,0,7
1458880,1057691,2021-04-20,Assembly,"Do pass as amended and be re-referred to the Committee on [Appropriations]",19,0,0,0,19
1458880,1073359,2021-05-05,Assembly,"Do pass. To Consent Calendar",16,0,0,0,16
1458880,1077578,2021-05-13,Assembly,"AB 1328 Irwin Assembly Third Reading",71,0,7,0,78
1458881,1067622,2021-04-29,Assembly,"Do pass as amended and be re-referred to the Committee on [Appropriations]",6,2,0,0,8
1458882,1049026,2021-04-08,Assembly,"Do pass and be re-referred to the Committee on [Appropriations] with recommendation: To Consent Calendar",22,0,0,0,22
1458882,1059241,2021-04-21,Assembly,"Do pass. To Consent Calendar",14,0,2,0,16
1458882,1066712,2021-04-29,Assembly,"AB 1330 Frazier Consent Calendar Second Day Regular Session",77,0,1,0,78
1458883,1046140,2021-04-06,Assembly,"Do pass as amended and be re-referred to the Committee on [Appropriations]",15,0,0,0,15
1458888,1065215,2021-04-27,Assembly,"Do pass and be re-referred to the Committee on [Appropriations] with recommendation: To Consent Calendar",8,0,0,0,8
1458889,1053492,2021-04-13,Assembly,"Do pass and be re-referred to the Committee on [Transportation] with recommendation: To Consent Calendar",8,0,0,0,8
1458889,1064078,2021-04-26,Assembly,"Do pass and be re-referred to the Committee on [Appropriations] with recommendation: To Consent Calendar",15,0,0,0,15
1458889,1076939,2021-05-12,Assembly,"Do pass",16,0,0,0,16
1458890,1047438,2021-04-07,Assembly,"Do pass and be re-referred to the Committee on [Revenue and Taxation]",6,2,0,0,8
1458893,1051939,2021-04-13,Assembly,"Do pass as amended and be re-referred to the Committee on [Judiciary]",11,1,3,0,15
1458893,1064001,2021-04-27,Assembly,"Do pass as amended and be re-referred to the Committee on [Appropriations]",8,3,0,0,11
1458896,1065199,2021-04-28,Assembly,"Do pass and be re-referred to the Committee on [Appropriations]",6,4,1,0,11
1458896,1076936,2021-05-12,Assembly,"Do pass",11,4,1,0,16
1458897,1057646,2021-04-19,Assembly,"Do pass. To Consent Calendar",6,0,1,0,7
1458897,1062785,2021-04-26,Assembly,"Do pass and be re-referred to the Committee on [Appropriations] with recommendation: To Consent Calendar",8,0,0,0,8
1458898,1065195,2021-04-28,Assembly,"Do pass and be re-referred to the Committee on [Appropriations]",7,3,1,0,11
1458898,1076921,2021-05-12,Assembly,"Set, [First] hearing. Referred to suspense file",16,0,0,0,16
1458899,1065141,2021-04-27,Assembly,"Do pass. To Consent Calendar",8,0,0,0,8
1458899,1074108,2021-05-06,Assembly,"AB 1347 Jones-Sawyer Consent Calendar Second Day Regular Session",77,0,1,0,78
1458900,1062797,2021-04-26,Assembly,"Do pass and be re-referred to the Committee on [Appropriations]",6,0,1,0,7
1458901,1054731,2021-04-14,Assembly,"Do pass as amended and be re-referred to the Committee on [Judiciary]",13,0,0,0,13
1458901,1063999,2021-04-27,Assembly,"Do pass and be re-referred to the Committee on [Appropriations] with recommendation: To Consent Calendar",11,0,0,0,11
1458901,1076968,2021-05-12,Assembly,"Do pass. To Consent Calendar",16,0,0,0,16
1458904,1048894,2021-04-08,Assembly,"Do pass and be re-referred to the Committee on [Military and Veterans Affairs] with recommendation: To Consent Calendar",11,0,0,0,11
1458904,1065266,2021-04-28,Assembly,"Do pass and be re-referred to the Committee on [Appropriations]",11,0,0,0,11
1458904,1076948,2021-05-12,Assembly,"Do pass. To Consent Calendar",16,0,0,0,16
1458908,1053491,2021-04-13,Assembly,"Do pass and be re-referred to the Committee on [Privacy and Consumer Protection]",6,2,0,0,8
1458908,1060858,2021-04-22,Assembly,"Do pass and be re-referred to the Committee on [Appropriations]",8,2,1,0,11
1458909,1051973,2021-04-13,Assembly,"Do pass and be re-referred to the Committee on [Appropriations]",15,0,0,0,15
1458910,1065284,2021-04-28,Assembly,"Do pass and be re-referred to the Committee on [Appropriations]",7,0,0,0,7
1458912,1067614,2021-04-29,Assembly,"Do pass as amended and be re-referred to the Committee on [Appropriations]",6,2,0,0,8
1458913,1047571,2021-04-07,Assembly,"Do pass and be re-referred to the Committee on [Education]",8,0,0,0,8
1458913,1065183,2021-04-28,Assembly,"Do pass as amended and be re-referred to the Committee on [Appropriations]",6,1,0,0,7
1458914,1066786,2021-04-29,Assembly,"Do pass and be re-referred to the Committee on [Appropriations] with recommendation: To Consent Calendar",11,0,0,0,11
1458916,1053513,2021-04-14,Assembly,"Do pass and be re-referred to the Committee on [Natural Resources]",5,1,1,0,7
1458918,1054716,2021-04-15,Assembly,"Do pass as amended, and be re-referred to the Committee on [Appropriations] with recommendation: To Consent Calendar",7,0,0,0,7
1458918,1073445,2021-05-05,Assembly,"Do pass. To Consent Calendar",16,0,0,0,16
1458919,1059192,2021-04-21,Assembly,"Do pass and be re-referred to the Committee on [Appropriations]",8,0,0,0,8
1458920,1053529,2021-04-14,Assembly,"Do pass and be re-referred to the Committee on [Natural Resources]",5,1,1,0,7
1458922,1053470,2021-04-14,Assembly,"Do pass and be re-referred to the Committee on [Judiciary]",8,3,0,0,11
1458922,1057621,2021-04-20,Assembly,"Do pass as amended and be re-referred to the Committee on [Appropriations]",8,2,1,0,11
1458925,1064021,2021-04-26,Assembly,"Do pass and be re-referred to the Committee on [Appropriations] with recommendation: To Consent Calendar",15,0,0,0,15
1458925,1076950,2021-05-12,Assembly,"Do pass. To Consent Calendar",16,0,0,0,16
1458928,1049034,2021-04-08,Assembly,"Do pass and be re-referred to the Committee on [Appropriations]",11,0,1,0,12
1458934,1048944,2021-04-08,Assembly,"Do pass",11,0,1,0,12
1458934,1074194,2021-05-06,Assembly,"AB 1383 Carrillo Assembly Third Reading",77,0,1,0,78
1458935,1053553,2021-04-14,Assembly,"Do pass and be re-referred to the Committee on [Appropriations]",8,2,1,0,11
1458937,1065287,2021-04-27,Assembly,"Do pass and be re-referred to the Committee on [Appropriations]",19,0,0,0,19
1458939,1057703,2021-04-20,Assembly,"Do pass as amended and be re-referred to the Committee on [Appropriations]",15,0,0,0,15
1458940,1056431,2021-04-19,Assembly,"Do pass and be re-referred to the Committee on [Appropriations]",13,1,1,0,15
1458940,1076944,2021-05-12,Assembly,"Do pass",13,3,0,0,16
1458941,1065308,2021-04-28,Assembly,"Do pass and be re-referred to the Committee on [Appropriations]",10,0,1,0,11
1458942,1049005,2021-04-08,Assembly,"Do pass as amended. To Consent Calendar",11,0,0,0,11
1458942,1056484,2021-04-19,Assembly,"AB 1391 Chau Consent Calendar Second Day Regular Session",78,0,1,0,79
1458946,1065149,2021-04-28,Assembly,"Do pass as amended and be re-referred to the Committee on [Appropriations]",8,3,0,0,11
1458949,1054675,2021-04-15,Assembly,"Do pass and be re-referred to the Committee on [Local Government]",6,2,0,0,8
1458949,1065142,2021-04-28,Assembly,"Do pass as amended and be re-referred to the Committee on [Appropriations]",5,1,2,0,8
1458952,1054690,2021-04-14,Assembly,"Do pass as amended and be re-referred to the Committee on [Housing and Community Development]",6,1,1,0,8
1458952,1067633,2021-04-29,Assembly,"Do pass and be re-referred to the Committee on [Appropriations]",7,1,0,0,8
1458953,1046113,2021-04-05,Assembly,"Do pass and be re-referred to the Committee on [Appropriations]",6,2,3,0,11
1458953,1059320,2021-04-21,Assembly,"Do pass",10,2,4,0,16
1458953,1062767,2021-04-26,Assembly,"AB 1402 Levine Assembly Third Reading",51,17,10,0,78
1458954,1046112,2021-04-05,Assembly,"Do pass as amended and be re-referred to the Committee on [Appropriations]",7,0,0,0,7
1458954,1065224,2021-04-28,Assembly,"Do pass",15,1,0,0,16
1458954,1068152,2021-05-03,Assembly,"AB 1403 Levine Third Reading Urgency",62,0,16,0,78
1458956,1054598,2021-04-15,Assembly,"Do pass as amended and be re-referred to the Committee on [Judiciary]",9,3,0,0,12
1458956,1072238,2021-05-04,Assembly,"Do pass as amended and be re-referred to the Committee on [Appropriations]",8,2,1,0,11
1458958,1046106,2021-04-06,Assembly,"Do pass and be re-referred to the Committee on [Health]",15,0,4,0,19
1458958,1064104,2021-04-27,Assembly,"Do pass and be re-referred to the Committee on [Appropriations]",13,0,2,0,15
1458960,1054614,2021-04-14,Assembly,"Do pass and be re-referred to the Committee on [Emergency Management] with recommendation: To Consent Calendar",8,0,0,0,8
1458960,1057644,2021-04-19,Assembly,"Do pass. To Consent Calendar",6,0,1,0,7
1458960,1065081,2021-04-28,Assembly,"Do pass. To Consent Calendar",16,0,0,0,16
1458960,1074146,2021-05-06,Assembly,"AB 1409 Levine Consent Calendar Second Day Regular Session",77,0,1,0,78
1458968,1060939,2021-04-22,Assembly,"Do pass and be re-referred to the Committee on [Appropriations]",12,0,0,0,12
1458973,1057649,2021-04-20,Assembly,"Do pass as amended and be re-referred to the Committee on [Appropriations]",12,2,1,0,15
1458974,1067609,2021-04-29,Assembly,"Do pass and be re-referred to the Committee on [Appropriations] with recommendation: To Consent Calendar",8,0,0,0,8
1458976,1065210,2021-04-28,Assembly,"Do pass and be re-referred to the Committee on [Appropriations]",10,3,0,0,13
1458977,1054673,2021-04-14,Assembly,"Do pass and be re-referred to the Committee on [Appropriations]",13,0,0,0,13
1458977,1065219,2021-04-28,Assembly,"Do pass. To Consent Calendar",16,0,0,0,16
1458977,1074109,2021-05-06,Assembly,"AB 1426 Mathis Consent Calendar Second Day Regular Session",77,0,1,0,78
1458979,1059184,2021-04-21,Assembly,"Do pass and be re-referred to the Committee on [Appropriations] with recommendation: To Consent Calendar",9,0,0,0,9
1458980,1065197,2021-04-28,Assembly,"Do pass and be re-referred to the Committee on [Appropriations] with recommendation: To Consent Calendar",7,0,0,0,7
1458981,1052025,2021-04-13,Assembly,"Do pass as amended and be re-referred to the Committee on [Appropriations]",13,4,2,0,19
1458981,1053566,2021-04-13,Assembly,"Do pass as amended and be re-referred to the Committee on [Judiciary]",13,4,2,0,19
1458981,1057711,2021-04-20,Assembly,"Do pass as amended and be re-referred to the Committee on [Appropriations]",8,2,1,0,11
1458982,1065238,2021-04-28,Assembly,"Do pass as amended and be re-referred to the Committee on [Appropriations]",11,0,0,0,11
1458983,1049024,2021-04-08,Assembly,"Do pass and be re-referred to the Committee on [Appropriations]",11,0,1,0,12
1458983,1065116,2021-04-28,Assembly,"Do pass as amended",15,0,1,0,16
1458983,1074173,2021-05-06,Assembly,"AB 1432 Low Assembly Third Reading",71,0,7,0,78
1458985,1064111,2021-04-26,Assembly,"Do pass and be re-referred to the Committee on [Appropriations]",8,6,1,0,15
1458987,1048881,2021-04-08,Assembly,"Do pass. To Consent Calendar",11,0,0,0,11
1458987,1054729,2021-04-15,Assembly,"AB 1436 Chau Consent Calendar Second Day Regular Session",75,0,3,0,78
1458992,1057683,2021-04-19,Assembly,"Do pass. To Consent Calendar",6,0,1,0,7
1458994,1057648,2021-04-20,Assembly,"Do pass and be re-referred to the Committee on [Appropriations]",15,0,0,0,15
1458995,1060987,2021-04-22,Assembly,"Do pass as amended",9,0,2,0,11
1458995,1074174,2021-05-06,Assembly,"AB 1444 Lee Assembly Third Reading",68,0,10,0,78
1458998,1057713,2021-04-19,Assembly,"Do pass and be re-referred to the Committee on [Jobs, Economic Development, and the Economy]",6,0,1,0,7
1458998,1064028,2021-04-27,Assembly,"Do pass as amended and be re-referred to the Committee on [Appropriations]",6,0,1,0,7
1459001,1046202,2021-04-05,Assembly,"Do pass as amended and be re-referred to the Committee on [Appropriations]",7,0,0,0,7
1459003,1065211,2021-04-27,Assembly,"Do pass and be re-referred to the Committee on [Appropriations] with recommendation: To Consent Calendar",8,0,0,0,8
1459003,1076958,2021-05-12,Assembly,"Do pass. To Consent Calendar",16,0,0,0,16
1459004,1048923,2021-04-08,Assembly,"Do pass and be re-referred to the Committee on [Natural Resources]",5,0,2,0,7
1459004,1065250,2021-04-28,Assembly,"Do pass and be re-referred to the Committee on [Appropriations]",8,0,3,0,11
1459005,1053498,2021-04-14,Assembly,"Do pass as amended and be re-referred to the Committee on [Appropriations]",11,0,0,0,11
1459006,1046136,2021-04-06,Assembly,"Do pass as amended and be re-referred to the Committee on [Appropriations]",10,0,1,0,11
1459007,1060928,2021-04-22,Assembly,"Do pass and be re-referred to the Committee on [Appropriations]",10,0,2,0,12
1459012,1059188,2021-04-21,Assembly,"Do pass and be re-referred to the Committee on [Appropriations]",8,0,0,0,8
1459016,1066741,2021-04-29,Assembly,"Do pass and be re-referred to the Committee on [Appropriations] with recommendation: To Consent Calendar",13,0,0,0,13
1459017,1051888,2021-04-13,Assembly,"Do pass and be re-referred to the Committee on [Appropriations]",9,0,2,0,11
1459018,1060862,2021-04-22,Assembly,"Do pass and be re-referred to the Committee on [Judiciary]",10,0,2,0,12
1459018,1064153,2021-04-27,Assembly,"Do pass as amended and be re-referred to the Committee on [Appropriations]",10,0,1,0,11
1459019,1064019,2021-04-27,Assembly,"Do pass as amended and be re-referred to the Committee on [Appropriations]",13,0,2,0,15
1459021,1046138,2021-04-06,Assembly,"Do pass as amended, and be re-referred to the Committee on [Military and Veterans Affairs] with recommendation: To Consent Calendar",15,0,0,0,15
1459021,1065275,2021-04-28,Assembly,"Do pass and be re-referred to the Committee on [Appropriations] with recommendation: To Consent Calendar",11,0,0,0,11
1459022,1059319,2021-04-21,Assembly,"Do pass as amended and be re-referred to the Committee on [Appropriations]",13,1,1,0,15
1459022,1073389,2021-05-05,Assembly,"Do pass",16,0,0,0,16
1459022,1077572,2021-05-13,Assembly,"AB 1471 Villapudua Assembly Third Reading",72,4,2,0,78
1459025,1059157,2021-04-20,Assembly,"Do pass and be re-referred to the Committee on [Appropriations]",6,2,0,0,8
1459026,1053549,2021-04-13,Assembly,"Do pass and be re-referred to the Committee on [Privacy and Consumer Protection]",7,0,1,0,8
1459026,1060842,2021-04-22,Assembly,"Do pass",10,0,1,0,11
1459026,1074112,2021-05-06,Assembly,"AB 1475 Low Assembly Third Reading",74,0,4,0,78
1459027,1036441,2021-03-24,Assembly,"Do pass as amended, and be re-referred to the Committee on [Appropriations] with recommendation: To Consent Calendar",8,0,0,0,8
1459027,1053451,2021-04-14,Assembly,"Do pass. To Consent Calendar",16,0,0,0,16
1459027,1060942,2021-04-22,Assembly,"AB 1476 Gray Consent Calendar Second Day Regular Session",77,0,2,0,79
1459028,1064163,2021-04-27,Assembly,"Do pass as amended, and be re-referred to the Committee on [Appropriations] with recommendation: To Consent Calendar",15,0,0,0,15
1459031,1065204,2021-04-27,Assembly,"Do pass and be re-referred to the Committee on [Appropriations]",8,0,0,0,8
1459031,1076940,2021-05-12,Assembly,"Do pass. To Consent Calendar",16,0,0,0,16
1459034,1065098,2021-04-28,Assembly,"Do pass and be re-referred to the Committee on [Appropriations] with recommendation: To Consent Calendar",13,0,0,0,13
1459037,1053518,2021-04-14,Assembly,"Do pass and be re-referred to the Committee on [Housing and Community Development]",8,1,2,0,11
1459038,1046158,2021-04-06,Assembly,"Do pass as amended",9,2,0,0,11
1459039,1057656,2021-04-19,Assembly,"Do pass. To Consent Calendar",6,0,1,0,7
1459041,1049016,2021-04-08,Assembly,"Do pass and be re-referred to the Committee on [Appropriations]",9,0,2,0,11
1459041,1065241,2021-04-28,Assembly,"Do pass",12,0,4,0,16
1459042,1048956,2021-04-08,Assembly,"Do pass and be re-referred to the Committee on [Education]",11,0,1,0,12
1459042,1065134,2021-04-28,Assembly,"Do pass and be re-referred to the Committee on [Appropriations]",5,1,1,0,7
1459042,1076964,2021-05-12,Assembly,"Do pass",16,0,0,0,16
1459043,1067611,2021-04-29,Assembly,"Do pass and be re-referred to the Committee on [Appropriations]",6,2,0,0,8
1459045,1057688,2021-04-20,Assembly,"Do pass as amended and be re-referred to the Committee on [Business and Professions]",12,1,2,0,15
1459045,1065276,2021-04-27,Assembly,"Do pass as amended",15,0,4,0,19
1459046,1066699,2021-04-29,Assembly,"Do pass and be re-referred to the Committee on [Appropriations]",6,1,0,0,7
1459050,1044988,2021-04-05,Assembly,"Do pass and be re-referred to the Committee on [Appropriations] with recommendation: To Consent Calendar",14,0,1,0,15
1459051,1049881,2021-04-08,Assembly,"Do pass as amended and be re-referred to the Committee on [Natural Resources]",9,0,6,0,15
1459051,1073349,2021-05-05,Assembly,"Do pass as amended and be re-referred to the Committee on [Appropriations]",8,1,2,0,11
1459054,1045003,2021-04-05,Assembly,"Do pass and be re-referred to the Committee on [Privacy and Consumer Protection]",13,0,2,0,15
1459054,1060890,2021-04-22,Assembly,"Do pass as amended and be re-referred to the Committee on [Appropriations]",10,0,1,0,11
1459057,1060985,2021-04-22,Assembly,"Do pass",5,1,1,0,7
1459060,1065188,2021-04-27,Assembly,"Do pass and be re-referred to the Committee on [Appropriations]",6,2,0,0,8
1459062,1066737,2021-04-29,Assembly,"Do pass as amended, and be re-referred to the Committee on [Appropriations] with recommendation: To Consent Calendar",13,0,0,0,13
1459062,1076956,2021-05-12,Assembly,"Do pass. To Consent Calendar",16,0,0,0,16
1459063,1064113,2021-04-26,Assembly,"Do pass and be re-referred to the Committee on [Appropriations]",11,4,0,0,15
1459066,1057616,2021-04-19,Assembly,"Do pass as amended and be re-referred to the Committee on [Appropriations]",9,0,2,0,11
1459071,1064145,2021-04-27,Assembly,"Do pass and be re-referred to the Committee on [Appropriations]",14,0,1,0,15
1459075,1064097,2021-04-26,Assembly,"Do pass and be re-referred to the Committee on [Appropriations] with recommendation: To Consent Calendar",15,0,0,0,15
1459078,1057694,2021-04-20,Assembly,"Do pass and be re-referred to the Committee on [Appropriations]",15,0,0,0,15
1459078,1065091,2021-04-28,Assembly,"Do pass. To Consent Calendar",16,0,0,0,16
1459078,1074129,2021-05-06,Assembly,"AB 1527 Ting Consent Calendar Second Day Regular Session",77,0,1,0,78
1459082,1059186,2021-04-21,Assembly,"Do pass as amended, and be re-referred to the Committee on [Natural Resources] with recommendation: To Consent Calendar",15,0,0,0,15
1459083,1065309,2021-04-27,Assembly,"Do pass as amended",19,0,0,0,19
1459084,1065086,2021-04-27,Assembly,"Do pass and be re-referred to the Committee on [Appropriations]",18,0,1,0,19
1459085,1065236,2021-04-27,Assembly,"Do pass and be re-referred to the Committee on [Appropriations] with recommendation: To Consent Calendar",19,0,0,0,19
1459086,1065198,2021-04-27,Assembly,"Do pass and be re-referred to the Committee on [Appropriations]",19,0,0,0,19
1459087,1065278,2021-04-27,Assembly,"Do pass as amended and be re-referred to the Committee on [Appropriations]",19,0,0,0,19
1459088,1065099,2021-04-27,Assembly,"Do pass and be re-referred to the Committee on [Appropriations]",18,0,1,0,19
1459088,1074125,2021-05-06,Assembly,"AB 1537 Low Assembly Third Reading",76,0,2,0,78
1459089,1057684,2021-04-19,Assembly,"Do pass as amended and be re-referred to the Committee on [Appropriations]",11,0,0,0,11
1459091,1065263,2021-04-27,Assembly,"Do pass and be re-referred to the Committee on [Appropriations]",6,2,0,0,8
1459092,1054720,2021-04-15,Assembly,"Do pass and be re-referred to the Committee on [Appropriations] with recommendation: To Consent Calendar",13,0,0,0,13
1459092,1065138,2021-04-28,Assembly,"Do pass. To Consent Calendar",16,0,0,0,16
1459092,1074159,2021-05-06,Assembly,"AB 1541 INS. Consent Calendar Second Day Regular Session",77,0,1,0,78
1459093,1053405,2021-04-13,Assembly,"Do pass and be re-referred to the Committee on [Health]",7,0,1,0,8
1459093,1064134,2021-04-27,Assembly,"Do pass as amended and be re-referred to the Committee on [Appropriations]",11,2,2,0,15
1459096,1048942,2021-04-08,Assembly,"Do pass as amended and be re-referred to the Committee on [Arts, Entertainment, Sports, Tourism, and Internet Media]",9,1,1,0,11
1459096,1062754,2021-04-26,Assembly,"Do pass and be re-referred to the Committee on [Appropriations]",4,0,3,0,7
1459097,1054616,2021-04-14,Assembly,"Do pass as amended and be re-referred to the Committee on [Elections]",7,0,1,0,8
1459097,1066715,2021-04-29,Assembly,"Do pass",7,0,0,0,7
1459101,1054630,2021-04-15,Assembly,"Do pass and be re-referred to the Committee on [Appropriations]",6,0,1,0,7
1459101,1065117,2021-04-28,Assembly,"Do pass",12,4,0,0,16
1459103,1065092,2021-04-27,Assembly,"Do pass and be re-referred to the Committee on [Appropriations]",2,4,13,0,19
1459107,1050788,2021-04-12,Assembly,"Do pass and be re-referred to the Committee on [Privacy and Consumer Protection]",6,0,1,0,7
1459107,1060856,2021-04-22,Assembly,"Do pass as amended and be re-referred to the Committee on [Appropriations]",11,0,0,0,11
1459111,1048953,2021-04-07,Assembly,"Do pass and be re-referred to the Committee on [Privacy and Consumer Protection] with recommendation: To Consent Calendar",7,0,0,0,7
1459111,1060966,2021-04-22,Assembly,"Do pass and be re-referred to the Committee on [Appropriations]",11,0,0,0,11
1459114,1065144,2021-04-28,Assembly,"Be adopted. To Consent Calendar",11,0,0,0,11
1459115,1016215,2021-02-25,Assembly,"Be adopted. To third reading",11,0,1,0,12
1459116,1016175,2021-02-25,Assembly,"Be adopted. To Consent Calendar",11,0,1,0,12
1459116,1022304,2021-03-04,Assembly,"HR 25 Bonta Consent Calendar Second Day Regular Session",72,0,7,0,79
1459117,1056361,2021-04-19,Senate,"Do pass, but first be re-referred to the Committee on [Appropriations]",5,0,0,0,5
1459117,1068197,2021-05-03,Senate,"Placed on suspense file",6,0,1,0,7
1459118,1046103,2021-04-06,Senate,"Do pass, but first be re-referred to the Committee on [Transportation] with the recommendation: To Consent Calendar",5,0,0,0,5
1459118,1064036,2021-04-27,Senate,"Do pass, but first be re-referred to the Committee on [Appropriations] with the recommendation: To Consent Calendar",15,0,2,0,17
1459118,1077622,2021-05-13,Senate,"Consent Calendar SB629",38,0,2,0,40
1459122,1053552,2021-04-13,Senate,"Do pass, but first be re-referred to the Committee on [Appropriations]",8,0,3,0,11
1459123,1038696,2021-03-22,Senate,"Do pass, but first be re-referred to the Committee on [Appropriations] with the recommendation: To Consent Calendar",5,0,0,0,5
1459123,1048975,2021-04-08,Senate,"Consent Calendar SB634 L., P.E. & R",38,0,2,0,40
1459124,1051942,2021-04-13,Senate,"Do pass, but first be re-referred to the Committee on [Appropriations] with the recommendation: To Consent Calendar",16,0,1,0,17
1459124,1068293,2021-05-03,Senate,"Placed on suspense file",6,0,1,0,7
1459126,1065160,2021-04-28,Senate,"Do pass, but first be re-referred to the Committee on [Appropriations]",9,1,1,0,11
1459127,1047467,2021-04-07,Senate,"Do pass as amended, but first amend, and re-refer to the Committee on [Judiciary]",9,0,0,0,9
1459127,1053455,2021-04-13,Senate,"Do pass, but first be re-referred to the Committee on [Appropriations] with the recommendation: To Consent Calendar",10,0,1,0,11
1459127,1075261,2021-05-10,Senate,"Consent Calendar SB638",37,0,3,0,40
1459128,1038699,2021-03-22,Senate,"Do pass, but first be re-referred to the Committee on [Human Services]",4,0,1,0,5
1459128,1057664,2021-04-20,Senate,"Do pass as amended, but first amend, and re-refer to the Committee on [Appropriations]",4,1,0,0,5
1459128,1068268,2021-05-03,Senate,"Placed on suspense file",6,0,1,0,7
1459129,1051983,2021-04-13,Senate,"Do pass, but first be re-referred to the Committee on [Appropriations] with the recommendation: To Consent Calendar",16,0,1,0,17
1459129,1068232,2021-05-03,Senate,"Placed on suspense file",6,0,1,0,7
1459131,1059269,2021-04-20,Senate,"Do pass, but first be re-referred to the Committee on [Rules]",8,2,1,0,11
1459131,1065217,2021-04-28,Senate,"Do pass as amended, but first amend, and re-refer to the Committee on [Appropriations]",9,1,1,0,11
1459132,1050777,2021-04-12,Senate,"Do pass as amended, but first amend, and re-refer to the Committee on [Transportation]",7,0,0,0,7
1459132,1064093,2021-04-27,Senate,"Do pass as amended, but first amend, and re-refer to the Committee on [Appropriations]",16,0,1,0,17
1459133,1047484,2021-04-07,Senate,"Do pass, but first be re-referred to the Committee on [Labor, Public Employment and Retirement ]",11,0,0,0,11
1459133,1064014,2021-04-26,Senate,"Do pass, but first be re-referred to the Committee on [Appropriations] with the recommendation: To Consent Calendar",5,0,0,0,5
1459133,1077538,2021-05-13,Senate,"Consent Calendar SB644",38,0,2,0,40
1459135,1062773,2021-04-26,Senate,"Do pass, but first be re-referred to the Committee on [Appropriations]",14,0,0,0,14
1459135,1077520,2021-05-13,Senate,"Senate 3rd Reading SB646 Hertzberg",38,0,2,0,40
1459136,1047466,2021-04-06,Senate,"Do pass, but first be re-referred to the Committee on [Appropriations] with the recommendation: To Consent Calendar",11,0,0,0,11
1459136,1060879,2021-04-22,Senate,"Consent Calendar SB647",38,0,2,0,40
1459137,1057717,2021-04-20,Senate,"Do pass, but first be re-referred to the Committee on [Appropriations] with the recommendation: To Consent Calendar",5,0,0,0,5
1459138,1054711,2021-04-15,Senate,"Do pass as amended, but first amend, and re-refer to the Committee on [Judiciary]",9,0,0,0,9
1459138,1072278,2021-05-04,Senate,"Do pass",11,0,0,0,11
1459138,1075260,2021-05-10,Senate,"Senate 3rd Reading SB649 Cortese",37,0,3,0,40
1459139,1059355,2021-04-21,Senate,"Do pass as amended, but first amend, and re-refer to the Committee on [Appropriations]",8,2,1,0,11
1459141,1056355,2021-04-19,Senate,"Do pass, but first be re-referred to the Committee on [Appropriations]",12,0,2,0,14
1459143,1053437,2021-04-13,Senate,"Do pass, but first be re-referred to the Committee on [Appropriations]",10,0,1,0,11
1459144,1037798,2021-03-25,Senate,"Do pass, but first be re-referred to the Committee on [Judiciary]",11,0,1,0,12
1459144,1072219,2021-05-04,Senate,"Do pass, but first be re-referred to the Committee on [Appropriations]",11,0,0,0,11
1459145,1074155,2021-05-06,Senate,"Do pass",5,0,0,0,5
1459146,1046137,2021-04-05,Senate,"Do pass, but first be re-referred to the Committee on [Judiciary]",5,0,0,0,5
1459146,1059278,2021-04-20,Senate,"Do pass as amended, and be ordered to the Consent Calendar",11,0,0,0,11
1459146,1066758,2021-04-29,Senate,"Consent Calendar SB657",36,0,4,0,40
1459147,1048943,2021-04-08,Senate,"Do pass, but first be re-referred to the Committee on [Military & Veterans Affairs]",5,0,0,0,5
1459147,1065292,2021-04-28,Senate,"Do pass, but first be re-referred to the Committee on [Appropriations]",7,0,0,0,7
1459147,1075318,2021-05-10,Senate,"Placed on suspense file",7,0,0,0,7
1459148,1053410,2021-04-14,Senate,"Do pass as amended, but first amend, and re-refer to the Committee on [Appropriations]",7,0,0,0,7
1459148,1068159,2021-05-03,Senate,"Placed on suspense file",6,0,1,0,7
1459149,1050783,2021-04-12,Senate,"Do pass, but first be re-referred to the Committee on [Judiciary]",3,2,0,0,5
1459149,1059288,2021-04-20,Senate,"Do pass, but first be re-referred to the Committee on [Appropriations]",8,2,1,0,11
1459149,1068175,2021-05-03,Senate,"Placed on suspense file",6,0,1,0,7
1459150,1030802,2021-03-17,Senate,"Do pass, but first be re-referred to the Committee on [Appropriations]",7,0,0,0,7
1459150,1044976,2021-04-05,Senate,"Placed on suspense file",7,0,0,0,7
1459151,1050791,2021-04-12,Senate,"Do pass as amended, but first amend, and re-refer to the Committee on [Environmental Quality]",10,3,1,0,14
1459151,1066771,2021-04-29,Senate,"Do pass as amended, but first amend, and re-refer to the Committee on [Appropriations]",6,0,1,0,7
1459152,1050835,2021-04-12,Senate,"Do pass, but first be re-referred to the Committee on [Judiciary]",4,1,0,0,5
1459153,1065209,2021-04-28,Senate,"Do pass, but first be re-referred to the Committee on [Appropriations]",10,0,1,0,11
1459153,1075310,2021-05-10,Senate,"Placed on suspense file",7,0,0,0,7
1459154,1047566,2021-04-06,Senate,"Do pass, but first be re-referred to the Committee on [Military & Veterans Affairs]",8,2,1,0,11
1459154,1053493,2021-04-14,Senate,"Do pass, but first be re-referred to the Committee on [Appropriations]",7,0,0,0,7
1459154,1068217,2021-05-03,Senate,"Placed on suspense file",6,0,1,0,7
1459155,1047549,2021-04-06,Senate,"Do pass, but first be re-referred to the Committee on [Appropriations] with the recommendation: To Consent Calendar",11,0,0,0,11
1459155,1056370,2021-04-19,Senate,"Placed on suspense file",7,0,0,0,7
1459156,1027191,2021-03-11,Senate,"Do pass, but first be re-referred to the Committee on [Military & Veterans Affairs] with the recommendation: To Consent Calendar",5,0,0,0,5
1459156,1053494,2021-04-14,Senate,"Do pass, but first be re-referred to the Committee on [Appropriations] with the recommendation: To Consent Calendar",7,0,0,0,7
1459156,1068163,2021-05-03,Senate,"Placed on suspense file",6,0,1,0,7
1459159,1065169,2021-04-27,Senate,"Do pass as amended, but first amend, and re-refer to the Committee on [Appropriations]",7,0,4,0,11
1459159,1075392,2021-05-10,Senate,"Placed on suspense file",7,0,0,0,7
1459160,1051936,2021-04-13,Senate,"Do pass, but first be re-referred to the Committee on [Environmental Quality]",15,0,2,0,17
1459160,1062771,2021-04-26,Senate,"Do pass as amended, but first amend, and re-refer to the Committee on [Appropriations]",7,0,0,0,7
1459162,1036479,2021-03-24,Senate,"Do pass, but first be re-referred to the Committee on [Appropriations] with the recommendation: To Consent Calendar",6,0,1,0,7
1459162,1060901,2021-04-22,Senate,"Consent Calendar SB673",38,0,2,0,40
1459163,1038798,2021-03-22,Senate,"Do pass, but first be re-referred to the Committee on [Transportation]",4,1,0,0,5
1459163,1064029,2021-04-27,Senate,"Do pass as amended, but first amend, and re-refer to the Committee on [Appropriations]",12,2,3,0,17
1459163,1075341,2021-05-10,Senate,"Placed on suspense file",7,0,0,0,7
1459164,1074180,2021-05-06,Senate,"Do pass",5,0,0,0,5
1459167,1035154,2021-03-23,Senate,"Do pass, but first be re-referred to the Committee on [Housing]",5,0,0,0,5
1459167,1054613,2021-04-15,Senate,"Do pass, but first be re-referred to the Committee on [Appropriations]",9,0,0,0,9
1459167,1068164,2021-05-03,Senate,"Placed on suspense file",6,0,1,0,7
1459168,1054631,2021-04-15,Senate,"Do pass, but first be re-referred to the Committee on [Governance and Finance]",6,1,2,0,9
1459168,1060926,2021-04-22,Senate,"Do pass, but first be re-referred to the Committee on [Appropriations]",4,0,1,0,5
1459171,1047591,2021-04-07,Senate,"Do pass as amended, but first amend, and re-refer to the Committee on [Appropriations] with the recommendation: To Consent Calendar",11,0,0,0,11
1459171,1068201,2021-05-03,Senate,"Placed on suspense file",6,0,1,0,7
1459173,1035189,2021-03-23,Senate,"Do pass as amended, but first amend, and re-refer to the Committee on [Appropriations]",13,0,2,0,15
1459173,1056377,2021-04-19,Senate,"Placed on suspense file",7,0,0,0,7
1459174,1038796,2021-03-22,Senate,"Do pass, but first be re-referred to the Committee on [Appropriations]",5,0,0,0,5
1459174,1050784,2021-04-12,Senate,"Senate 3rd Reading SB685 McGuire et al",39,0,1,0,40
1459175,1050789,2021-04-12,Senate,"Do pass, but first be re-referred to the Committee on [Appropriations]",4,1,0,0,5
1459175,1068227,2021-05-03,Senate,"Placed on suspense file",6,0,1,0,7
1459176,1036529,2021-03-24,Senate,"Do pass, but first be re-referred to the Committee on [Judiciary] with the recommendation: To Consent Calendar",11,0,0,0,11
1459176,1047529,2021-04-06,Senate,"Do pass as amended, but first amend, and re-refer to the Committee on [Appropriations] with the recommendation: To Consent Calendar",11,0,0,0,11
1459176,1068219,2021-05-03,Senate,"Placed on suspense file",6,0,1,0,7
1459177,1047435,2021-04-06,Senate,"Do pass, but first be re-referred to the Committee on [Appropriations]",9,2,0,0,11
1459177,1068222,2021-05-03,Senate,"Senate 3rd Reading SB688 Wieckowski",29,7,4,0,40
1459178,1059340,2021-04-21,Senate,"Do pass, but first be re-referred to the Committee on [Appropriations] with the recommendation: To Consent Calendar",11,0,0,0,11
1459180,1060964,2021-04-22,Senate,"Do pass, but first be re-referred to the Committee on [Appropriations]",4,0,1,0,5
1459180,1068273,2021-05-03,Senate,"Placed on suspense file",6,0,1,0,7
1459181,1053486,2021-04-14,Senate,"Do pass, but first be re-referred to the Committee on [Appropriations]",7,0,0,0,7
1459181,1068256,2021-05-03,Senate,"Placed on suspense file",6,0,1,0,7
1459182,1053560,2021-04-14,Senate,"Do pass, but first be re-referred to the Committee on [Appropriations]",7,0,0,0,7
1459182,1068168,2021-05-03,Senate,"Placed on suspense file",6,0,1,0,7
1459183,1056350,2021-04-19,Senate,"Do pass, but first be re-referred to the Committee on [Appropriations] with the recommendation: To Consent Calendar",14,0,0,0,14
1459183,1075296,2021-05-10,Senate,"Consent Calendar SB694",37,0,3,0,40
1459186,1066783,2021-04-29,Senate,"Do pass as amended, but first amend, and re-refer to the Committee on [Appropriations]",5,2,0,0,7
1459188,1047442,2021-04-07,Senate,"Do pass, but first be re-referred to the Committee on [Appropriations]",6,1,0,0,7
1459188,1056424,2021-04-19,Senate,"Placed on suspense file",7,0,0,0,7
1459189,1056337,2021-04-19,Senate,"Do pass, but first be re-referred to the Committee on [Appropriations]",5,0,0,0,5
1459190,1047475,2021-04-07,Senate,"Do pass, but first be re-referred to the Committee on [Judiciary] with the recommendation: To Consent Calendar",7,0,0,0,7
1459190,1075324,2021-05-10,Senate,"Consent Calendar SB701 ED",37,0,3,0,40
1459191,1057712,2021-04-20,Senate,"Do pass as amended, but first amend, and re-refer to the Committee on [Judiciary]",11,0,4,0,15
1459191,1065230,2021-04-27,Senate,"Do pass, but first be re-referred to the Committee on [Appropriations]",10,0,1,0,11
1459191,1075263,2021-05-10,Senate,"Placed on suspense file",7,0,0,0,7
1459192,1031908,2021-03-18,Senate,"Do pass, but first be re-referred to the Committee on [Judiciary]",5,0,0,0,5
1459192,1047436,2021-04-06,Senate,"Do pass as amended, but first amend, and re-refer to the Committee on [Appropriations] with the recommendation: To Consent Calendar",11,0,0,0,11
1459192,1060905,2021-04-22,Senate,"Consent Calendar SB703",38,0,2,0,40
1459194,1047440,2021-04-07,Senate,"Do pass, but first be re-referred to the Committee on [Labor, Public Employment and Retirement ]",6,0,1,0,7
1459194,1064127,2021-04-26,Senate,"Do pass, but first be re-referred to the Committee on [Appropriations]",5,0,0,0,5
1459194,1075330,2021-05-10,Senate,"Placed on suspense file",7,0,0,0,7
1459195,1074127,2021-05-06,Senate,"Do pass, but first be re-referred to the Committee on [Appropriations]",1,3,1,0,5
1459195,1074128,2021-05-06,Senate,"[First] hearing set for [05-06-2021]: Failed passage in Committee. Reconsideration granted",4,0,1,0,5
1459196,1046121,2021-04-06,Senate,"Do pass as amended, but first amend, and re-refer to the Committee on [Appropriations]",5,0,0,0,5
1459196,1075364,2021-05-10,Senate,"Senate 3rd Reading SB707 Cortese",37,0,3,0,40
1459197,1064010,2021-04-27,Senate,"Do pass and be ordered to the Consent Calendar",9,0,0,0,9
1459197,1068270,2021-05-03,Senate,"Consent Calendar SB708 Melendez",36,0,4,0,40
1459198,1054717,2021-04-15,Senate,"Do pass, but first be re-referred to the Committee on [Appropriations] with the recommendation: To Consent Calendar",9,0,0,0,9
1459198,1075297,2021-05-10,Senate,"Consent Calendar SB709",37,0,3,0,40
1459199,1046109,2021-04-06,Senate,"Do pass, but first be re-referred to the Committee on [Appropriations]",4,1,0,0,5
1459199,1056388,2021-04-19,Senate,"Placed on suspense file",7,0,0,0,7
1459201,1060915,2021-04-22,Senate,"Do pass, but first be re-referred to the Committee on [Appropriations]",3,1,1,0,5
1459202,1037854,2021-03-25,Senate,"Do pass, but first be re-referred to the Committee on [Appropriations] with the recommendation: To Consent Calendar",12,0,0,0,12
1459202,1060873,2021-04-22,Senate,"Consent Calendar SB713",38,0,2,0,40
1459203,1062795,2021-04-26,Senate,"Do pass as amended",4,0,1,0,5
1459204,1057665,2021-04-20,Senate,"Do pass, but first be re-referred to the Committee on [Appropriations]",4,1,0,0,5
1459204,1068147,2021-05-03,Senate,"Placed on suspense file",6,0,1,0,7
1459205,1054687,2021-04-15,Senate,"Do pass, but first be re-referred to the Committee on [Appropriations] with the recommendation: To Consent Calendar",9,0,0,0,9
1459205,1068156,2021-05-03,Senate,"Placed on suspense file",6,0,1,0,7
1459206,1047483,2021-04-07,Senate,"Do pass, but first be re-referred to the Committee on [Appropriations]",11,0,0,0,11
1459206,1068183,2021-05-03,Senate,"Placed on suspense file",6,0,1,0,7
1459207,1065167,2021-04-28,Senate,"Do pass as amended, but first amend, and re-refer to the Committee on [Appropriations]",11,0,0,0,11
1459208,1048928,2021-04-08,Senate,"Do pass as amended, but first amend, and re-refer to the Committee on [Appropriations]",5,0,0,0,5
1459208,1068176,2021-05-03,Senate,"Placed on suspense file",6,0,1,0,7
1459209,1051904,2021-04-13,Senate,"Do pass, but first be re-referred to the Committee on [Appropriations] with the recommendation: To Consent Calendar",5,0,0,0,5
1459209,1075315,2021-05-10,Senate,"Consent Calendar SB720",37,0,3,0,40
1459210,1025098,2021-03-09,Senate,"Do pass",13,0,1,0,14
1459210,1066707,2021-04-29,Senate,"Senate 3rd Reading SB721 Hueso et al",36,0,4,0,40
1459211,1036458,2021-03-24,Senate,"Do pass, but first be re-referred to the Committee on [Appropriations] with the recommendation: To Consent Calendar",6,0,1,0,7
1459211,1056391,2021-04-19,Senate,"Placed on suspense file",7,0,0,0,7
1459212,1065272,2021-04-28,Senate,"Do pass as amended, but first amend, and re-refer to the Committee on [Appropriations]",7,0,0,0,7
1459213,1053476,2021-04-13,Senate,"Do pass as amended, but first amend, and re-refer to the Committee on [Appropriations] with the recommendation: To Consent Calendar",10,0,1,0,11
1459213,1068193,2021-05-03,Senate,"Placed on suspense file",6,0,1,0,7
1459214,1047565,2021-04-07,Senate,"Do pass as amended, but first amend, and re-refer to the Committee on [Appropriations] with the recommendation: To Consent Calendar",7,0,0,0,7
1459214,1068251,2021-05-03,Senate,"Placed on suspense file",6,0,1,0,7
1459215,1050837,2021-04-12,Senate,"Do pass as amended, but first amend, and re-refer to the Committee on [Transportation]",5,1,1,0,7
1459215,1064079,2021-04-27,Senate,"Do pass, but first be re-referred to the Committee on [Appropriations]",13,1,3,0,17
1459215,1075248,2021-05-10,Senate,"Placed on suspense file",7,0,0,0,7
1459216,1056320,2021-04-19,Senate,"Do pass as amended, but first amend, and re-refer to the Committee on [Judiciary]",4,1,0,0,5
1459216,1065128,2021-04-27,Senate,"Do pass as amended, but first amend, and re-refer to the Committee on [Appropriations]",9,1,1,0,11
1459216,1075349,2021-05-10,Senate,"Placed on suspense file",7,0,0,0,7
1459217,1066689,2021-04-29,Senate,"Do pass, but first be re-referred to the Committee on [Appropriations] with the recommendation: To Consent Calendar",9,0,0,0,9
1459217,1075282,2021-05-10,Senate,"Placed on suspense file",7,0,0,0,7
1459218,1062750,2021-04-26,Senate,"Do pass and be ordered to the Consent Calendar",5,0,0,0,5
1459218,1066757,2021-04-29,Senate,"Consent Calendar SB729",36,0,4,0,40
1459220,1052020,2021-04-13,Senate,"Do pass as amended, but first amend, and re-refer to the Committee on [Appropriations]",4,1,0,0,5
1459220,1068279,2021-05-03,Senate,"Placed on suspense file",6,0,1,0,7
1459222,1062759,2021-04-26,Senate,"Do pass, but first be re-referred to the Committee on [Appropriations] with the recommendation: To Consent Calendar",14,0,0,0,14
1459222,1077573,2021-05-13,Senate,"Consent Calendar SB733",38,0,2,0,40
1459223,1060974,2021-04-22,Senate,"Do pass, but first be re-referred to the Committee on [Appropriations]",4,0,1,0,5
1459226,1036463,2021-03-24,Senate,"Do pass, but first be re-referred to the Committee on [Appropriations]",5,1,1,0,7
1459226,1056331,2021-04-19,Senate,"Placed on suspense file",7,0,0,0,7
1459228,1057627,2021-04-20,Senate,"Do pass, but first be re-referred to the Committee on [Appropriations]",4,1,0,0,5
1459228,1075246,2021-05-10,Senate,"Placed on suspense file",7,0,0,0,7
1459231,1057637,2021-04-20,Senate,"Do pass, but first be re-referred to the Committee on [Appropriations]",5,0,0,0,5
1459231,1068179,2021-05-03,Senate,"Placed on suspense file",6,0,1,0,7
1459232,1062776,2021-04-26,Senate,"Do pass, but first be re-referred to the Committee on [Appropriations]",14,0,0,0,14
1459232,1075370,2021-05-10,Senate,"Placed on suspense file",7,0,0,0,7
1459233,1059327,2021-04-21,Senate,"Do pass, but first be re-referred to the Committee on [Judiciary]",9,0,2,0,11
1459233,1065067,2021-04-27,Senate,"Do pass as amended, but first amend, and re-refer to the Committee on [Appropriations]",11,0,0,0,11
1459233,1075326,2021-05-10,Senate,"Placed on suspense file",7,0,0,0,7
1459235,1047555,2021-04-06,Senate,"Do pass, but first be re-referred to the Committee on [Appropriations]",9,1,1,0,11
1459235,1056379,2021-04-19,Senate,"Placed on suspense file",7,0,0,0,7
1459237,1046125,2021-04-06,Senate,"Do pass, but first be re-referred to the Committee on [Appropriations]",5,0,0,0,5
1459237,1056365,2021-04-19,Senate,"Placed on suspense file",7,0,0,0,7
1459238,1030794,2021-03-17,Senate,"Do pass, but first be re-referred to the Committee on [Appropriations]",11,0,0,0,11
1459238,1056430,2021-04-19,Senate,"Placed on suspense file",7,0,0,0,7
1459241,1062787,2021-04-26,Senate,"Do pass, but first be re-referred to the Committee on [Appropriations]",4,1,0,0,5
1459241,1075333,2021-05-10,Senate,"Placed on suspense file",7,0,0,0,7
1459242,1056366,2021-04-19,Senate,"Do pass, but first be re-referred to the Committee on [Appropriations] with the recommendation: To Consent Calendar",5,0,0,0,5
1459242,1077547,2021-05-13,Senate,"Consent Calendar SB753",38,0,2,0,40
1459244,1064159,2021-04-26,Senate,"Do pass, but first be re-referred to the Committee on [Appropriations]",5,0,0,0,5
1459244,1075356,2021-05-10,Senate,"Placed on suspense file",7,0,0,0,7
1459245,1056341,2021-04-19,Senate,"Do pass, but first be re-referred to the Committee on [Appropriations]",14,0,0,0,14
1459246,1044960,2021-04-05,Senate,"Do pass as amended, but first amend, and re-refer to the Committee on [Energy, Utilities and Communications]",13,1,0,0,14
1459249,1064054,2021-04-27,Senate,"Do pass, but first be re-referred to the Committee on [Appropriations]",13,1,3,0,17
1459251,1047586,2021-04-06,Senate,"Do pass and be ordered to the Consent Calendar",11,0,0,0,11
1459251,1060841,2021-04-22,Senate,"Consent Calendar SB762",38,0,2,0,40
1459252,1057732,2021-04-20,Senate,"Do pass, but first be re-referred to the Committee on [Appropriations]",5,0,0,0,5
1459252,1068184,2021-05-03,Senate,"Placed on suspense file",6,0,1,0,7
1459256,1053480,2021-04-14,Senate,"Do pass, but first be re-referred to the Committee on [Appropriations]",7,0,0,0,7
1459256,1068234,2021-05-03,Senate,"Placed on suspense file",6,0,1,0,7
1459257,1035218,2021-03-23,Senate,"Do pass as amended, but first amend, and re-refer to the Committee on [Appropriations]",5,0,0,0,5
1459257,1068249,2021-05-03,Senate,"Senate 3rd Reading SB768 Glazer et al",37,0,3,0,40
1459259,1065078,2021-04-28,Senate,"Do pass as amended, but first amend, and re-refer to the Committee on [Appropriations]",7,0,0,0,7
1459260,1074188,2021-05-06,Senate,"Do pass as amended, but first amend, and re-refer to the Committee on [Appropriations]",4,0,1,0,5
1459262,1053557,2021-04-14,Senate,"Do pass, but first be re-referred to the Committee on [Appropriations]",11,0,0,0,11
1459262,1068215,2021-05-03,Senate,"Placed on suspense file",6,0,1,0,7
1459263,1047457,2021-04-06,Senate,"Do pass",9,2,0,0,11
1459263,1060887,2021-04-22,Senate,"Senate 3rd Reading SB774 Hertzberg",27,10,3,0,40
1459264,1051979,2021-04-13,Senate,"Do pass, but first be re-referred to the Committee on [Appropriations]",4,1,0,0,5
1459264,1068174,2021-05-03,Senate,"Placed on suspense file",6,0,1,0,7
1459265,1050827,2021-04-12,Senate,"Do pass, but first be re-referred to the Committee on [Judiciary]",6,1,0,0,7
1459265,1065235,2021-04-27,Senate,"Do pass as amended, but first amend, and re-refer to the Committee on [Appropriations]",9,2,0,0,11
1459266,1060982,2021-04-22,Senate,"Do pass as amended, but first amend, and re-refer to the Committee on [Appropriations]",4,0,1,0,5
1459266,1075316,2021-05-10,Senate,"Placed on suspense file",7,0,0,0,7
1459267,1054671,2021-04-15,Senate,"Do pass as amended, but first amend, and re-refer to the Committee on [Housing]",5,0,0,0,5
1459267,1066812,2021-04-29,Senate,"Do pass as amended, but first amend, and re-refer to the Committee on [Appropriations]",9,0,0,0,9
1459268,1046110,2021-04-05,Senate,"Do pass as amended, but first amend, and re-refer to the Committee on [Appropriations]",5,0,0,0,5
1459268,1068285,2021-05-03,Senate,"Senate 3rd Reading SB779 Becker",36,0,4,0,40
1459269,1048884,2021-04-08,Senate,"Do pass as amended, but first amend, and re-refer to the Committee on [Housing]",5,0,0,0,5
1459269,1066703,2021-04-29,Senate,"Do pass as amended",8,0,1,0,9
1459269,1075346,2021-05-10,Senate,"Senate 3rd Reading SB780 Cortese",34,0,6,0,40
1459271,1036440,2021-03-24,Senate,"Do pass as amended, but first amend, and re-refer to the Committee on [Judiciary]",11,0,0,0,11
1459271,1047437,2021-04-06,Senate,"Do pass, but first be re-referred to the Committee on [Appropriations]",11,0,0,0,11
1459271,1075245,2021-05-10,Senate,"Senate 3rd Reading SB782 Glazer et al",37,0,3,0,40
1459273,1035195,2021-03-23,Senate,"Do pass, but first be re-referred to the Committee on [Appropriations] with the recommendation: To Consent Calendar",14,0,1,0,15
1459273,1060969,2021-04-22,Senate,"Consent Calendar SB784",38,0,2,0,40
1459274,1036417,2021-03-24,Senate,"Do pass, but first be re-referred to the Committee on [Appropriations]",6,0,1,0,7
1459274,1056402,2021-04-19,Senate,"Placed on suspense file",7,0,0,0,7
1459275,1074167,2021-05-06,Senate,"Do pass as amended",4,0,1,0,5
1459277,1038698,2021-03-22,Senate,"Do pass, but first be re-referred to the Committee on [Appropriations]",4,0,1,0,5
1459277,1056400,2021-04-19,Senate,"Placed on suspense file",7,0,0,0,7
1459279,1051938,2021-04-13,Senate,"Do pass as amended, but first amend, and re-refer to the Committee on [Rules] with the recommendation: To Consent Calendar",16,0,1,0,17
1459279,1064023,2021-04-27,Senate,"Do pass, but first be re-referred to the Committee on [Appropriations]",9,0,0,0,9
1459279,1075355,2021-05-10,Senate,"Placed on suspense file",7,0,0,0,7
1459280,1066823,2021-04-29,Senate,"Do pass, but first be re-referred to the Committee on [Governmental Organization]",8,0,1,0,9
1459281,1037864,2021-03-25,Senate,"Do pass, but first be re-referred to the Committee on [Appropriations]",4,1,0,0,5
1459281,1056396,2021-04-19,Senate,"Placed on suspense file",7,0,0,0,7
1459282,1057622,2021-04-20,Senate,"Do pass as amended, but first amend, and re-refer to the Committee on [Appropriations]",15,0,0,0,15
1459282,1068207,2021-05-03,Senate,"Placed on suspense file",6,0,1,0,7
1459283,1062752,2021-04-26,Senate,"Do pass and be ordered to the Consent Calendar",5,0,0,0,5
1459283,1066778,2021-04-29,Senate,"Consent Calendar SB794",36,0,4,0,40
1459285,1064067,2021-04-27,Senate,"Do pass as amended, but first amend, and re-refer to the Committee on [Appropriations] with the recommendation: To Consent Calendar",9,0,0,0,9
1459288,1055494,2021-04-15,Senate,"Do pass, but first be re-referred to the Committee on [Appropriations]",4,2,1,0,7
1459288,1068272,2021-05-03,Senate,"Placed on suspense file",6,0,1,0,7
1459289,1056401,2021-04-19,Senate,"Do pass as amended, but first amend, and re-refer to the Committee on [Appropriations]",13,0,1,0,14
1459290,1056372,2021-04-19,Senate,"Do pass, but first be re-referred to the Committee on [Appropriations]",13,0,1,0,14
1459291,1056409,2021-04-19,Senate,"Do pass, but first be re-referred to the Committee on [Education]",13,0,1,0,14
1459291,1065074,2021-04-28,Senate,"Do pass as amended",7,0,0,0,7
1459292,1056353,2021-04-19,Senate,"Do pass, but first be re-referred to the Committee on [Appropriations]",13,0,1,0,14
1459293,1051920,2021-04-13,Senate,"Do pass as amended, but first amend, and re-refer to the Committee on [Public Safety]",8,0,1,0,9
1459293,1064121,2021-04-27,Senate,"Do pass, but first be re-referred to the Committee on [Appropriations] with the recommendation: To Consent Calendar",5,0,0,0,5
1459293,1075291,2021-05-10,Senate,"Placed on suspense file",7,0,0,0,7
1459294,1064002,2021-04-26,Senate,"Do pass, but first be re-referred to the Committee on [Appropriations]",4,1,0,0,5
1459294,1075343,2021-05-10,Senate,"Placed on suspense file",7,0,0,0,7
1459295,1056354,2021-04-19,Senate,"Do pass, but first be re-referred to the Committee on [Appropriations]",13,0,1,0,14
1459296,1047471,2021-04-06,Senate,"Do pass as amended, but first amend, and re-refer to the Committee on [Appropriations]",10,0,1,0,11
1459296,1056406,2021-04-19,Senate,"Placed on suspense file",7,0,0,0,7
1459297,1056362,2021-04-19,Senate,"Do pass, but first be re-referred to the Committee on [Appropriations] with the recommendation: To Consent Calendar",13,0,1,0,14
1459297,1075284,2021-05-10,Senate,"Consent Calendar SB808",37,0,3,0,40
1459299,1051978,2021-04-13,Senate,"Be adopted, but first be re-referred to the Committee on [Appropriations] with recommendation: To Consent Calendar",15,0,2,0,17
1459299,1075363,2021-05-10,Senate,"Consent Calendar SCR15",37,0,3,0,40
1459300,1023830,2021-03-08,Senate,"Senate 3rd Reading SCR16 Caballero et al",35,0,4,0,39
1459300,1031883,2021-03-18,Assembly,"Be adopted. To Consent Calendar",7,0,5,0,12
1459300,1037853,2021-03-25,Assembly,"SCR 16 Caballero Consent Calendar Second Day Regular Session",74,0,4,0,78
1459302,1049025,2021-04-07,Assembly,"Do pass as amended and be re-referred to the Committee on [Appropriations]",7,0,0,0,7
1460743,1022336,2021-03-04,Assembly,"Be adopted. To third reading",11,0,1,0,12
1462479,1027183,2021-03-11,Senate,"Do pass and be ordered to the Consent Calendar",5,0,0,0,5
1462479,1033636,2021-03-22,Senate,"Consent Calendar SB810 GOV. & F. (McGuire) Urgency Clause",37,0,3,0,40
1462480,1027192,2021-03-11,Senate,"Do pass and be ordered to the Consent Calendar",5,0,0,0,5
1462480,1033665,2021-03-22,Senate,"Consent Calendar SB811 GOV. & F. (McGuire) Urgency Clause",37,0,3,0,40
1462481,1027168,2021-03-11,Senate,"Do pass and be ordered to the Consent Calendar",5,0,0,0,5
1462481,1033645,2021-03-22,Senate,"Consent Calendar SB812 GOV. & F",37,0,3,0,40
1462482,1060945,2021-04-22,Senate,"Do pass, but first be re-referred to the Committee on [Appropriations] with the recommendation: To Consent Calendar",5,0,0,0,5
1462482,1077546,2021-05-13,Senate,"Consent Calendar SB813 GOV. & F",38,0,2,0,40
1464452,1022305,2021-03-04,Assembly,"Be adopted. To Consent Calendar",11,0,1,0,12
1464452,1050781,2021-04-12,Senate,"Assembly 3rd Reading ACR34 Luz Rivas et al",39,0,1,0,40
1464453,1033638,2021-03-22,Senate,"Senate 3rd Reading SCR17 Leyva et al",37,0,3,0,40
1464453,1054660,2021-04-15,Assembly,"Be adopted. To Consent Calendar",12,0,0,0,12
1464453,1060983,2021-04-22,Assembly,"SCR 17 Leyva Consent Calendar Second Day Regular Session",77,0,2,0,79
1466692,1048955,2021-04-08,Assembly,"Do pass and be re-referred to the Committee on [Appropriations] with recommendation: To Consent Calendar",7,0,0,0,7
1470414,1054743,2021-04-15,Assembly,"Do pass and be re-referred to the Committee on [Appropriations] with recommendation: To Consent Calendar",13,0,0,0,13
1470415,1054730,2021-04-15,Assembly,"Do pass. To Consent Calendar",13,0,0,0,13
1470415,1060899,2021-04-22,Assembly,"AB 1563 INS. Consent Calendar Second Day Regular Session",77,0,2,0,79
1470416,1054719,2021-04-15,Assembly,"Do pass and be re-referred to the Committee on [Appropriations] with recommendation: To Consent Calendar",13,0,0,0,13
1470417,1037820,2021-03-25,Assembly,"Be adopted. To Consent Calendar",9,0,3,0,12
1470417,1048996,2021-04-08,Assembly,"ACR 35 Chau Consent Calendar Second Day Regular Session",74,0,4,0,78
1470417,1066710,2021-04-29,Senate,"Special Consent ACR35",36,0,4,0,40
1470420,1065131,2021-04-28,Assembly,"Be adopted. To third reading",11,0,0,0,11
1470420,1074150,2021-05-06,Assembly,"AJR 10 Choi Assembly Third Reading",76,0,2,0,78
1470421,1054694,2021-04-15,Assembly,"Be adopted. To third reading",6,0,1,0,7
1471514,1022326,2021-03-04,Assembly,"Be adopted. To third reading",11,0,1,0,12
1471514,1050844,2021-04-12,Senate,"Assembly 3rd Reading ACR38 Blanca Rubio et al",39,0,1,0,40
1471515,1037840,2021-03-25,Assembly,"Be adopted. To Consent Calendar",9,0,3,0,12
1471515,1048919,2021-04-08,Assembly,"ACR 39 Holden Consent Calendar Second Day Regular Session",74,0,4,0,78
1471515,1066782,2021-04-29,Senate,"Special Consent ACR39",36,0,4,0,40
1471516,1052027,2021-04-12,Assembly,"Be adopted. To Consent Calendar",15,0,0,0,15
1471516,1054619,2021-04-15,Assembly,"ACR 40 Mathis Consent Calendar Second Day Regular Session",75,0,3,0,78
1471517,1064072,2021-04-27,Senate,"Do pass, but first be re-referred to the Committee on [Appropriations] with the recommendation: To Consent Calendar",15,0,2,0,17
1471517,1077540,2021-05-13,Senate,"Consent Calendar SB814 TRANS",38,0,2,0,40
1471518,1054618,2021-04-15,Senate,"Do pass, but first be re-referred to the Committee on [Appropriations] with the recommendation: To Consent Calendar",5,0,0,0,5
1471518,1075336,2021-05-10,Senate,"Consent Calendar SB815 AGRI",37,0,3,0,40
1471519,1028417,2021-03-15,Senate,"Senate 3rd Reading SR13 Grove et al",39,0,1,0,40
1471520,1033607,2021-03-22,Senate,"Senate 3rd Reading SR14 Eggman",37,0,3,0,40
1471521,1028441,2021-03-15,Senate,"Senate 3rd Reading SR15 Skinner et al",39,0,1,0,40
1472774,1057673,2021-04-19,Assembly,"Do pass. To Consent Calendar",6,0,1,0,7
1472775,1057689,2021-04-19,Assembly,"Do pass. To Consent Calendar",6,0,1,0,7
1472776,1044939,2021-04-05,Assembly,"Do pass. To Consent Calendar",7,0,0,0,7
1472777,1057745,2021-04-20,Senate,"Do pass and be ordered to the Consent Calendar",15,0,0,0,15
1472777,1066836,2021-04-29,Senate,"Consent Calendar SB816 G.O. (Dodd)",36,0,4,0,40
1472778,1035234,2021-03-23,Senate,"Do pass, but first be re-referred to the Committee on [Appropriations] with the recommendation: To Consent Calendar",14,0,1,0,15
1472778,1048900,2021-04-08,Senate,"Consent Calendar SB817 G.O",38,0,2,0,40
1472779,1035254,2021-03-23,Senate,"Do pass, but first be re-referred to the Committee on [Appropriations] with the recommendation: To Consent Calendar",14,0,1,0,15
1472779,1045004,2021-04-05,Senate,"Do pass",7,0,0,0,7
1472779,1066738,2021-04-29,Senate,"Senate 3rd Reading SB818 G.O. (Dodd)",36,0,4,0,40
1472780,1057668,2021-04-20,Senate,"Do pass, but first be re-referred to the Committee on [Appropriations] with the recommendation: To Consent Calendar",15,0,0,0,15
1472780,1075243,2021-05-10,Senate,"Consent Calendar SB819 G.O",37,0,3,0,40
1472781,1035164,2021-03-23,Senate,"Do pass, but first be re-referred to the Committee on [Governance and Finance] with the recommendation: To Consent Calendar",14,0,1,0,15
1472781,1060851,2021-04-22,Senate,"Do pass as amended, but first amend, and re-refer to the Committee on [Appropriations]",5,0,0,0,5
1472781,1075283,2021-05-10,Senate,"Placed on suspense file",7,0,0,0,7
1474176,1053464,2021-04-14,Assembly,"Do pass and be re-referred to the Committee on [Appropriations] with recommendation: To Consent Calendar",11,0,0,0,11
1474176,1065243,2021-04-28,Assembly,"Do pass. To Consent Calendar",16,0,0,0,16
1474176,1074152,2021-05-06,Assembly,"AB 1570 NAT. RES. Consent Calendar Second Day Regular Session",77,0,1,0,78
1474177,1051921,2021-04-13,Assembly,"Do pass and be re-referred to the Committee on [Accountability and Administrative Review]",7,0,0,0,7
1474177,1065073,2021-04-28,Assembly,"Do pass and be re-referred to the Committee on [Appropriations] with recommendation: To Consent Calendar",7,0,0,0,7
1474178,1051908,2021-04-13,Assembly,"Do pass and be re-referred to the Committee on [Revenue and Taxation] with recommendation: To Consent Calendar",7,0,0,0,7
1474179,1064139,2021-04-27,Assembly,"Do pass and be re-referred to the Committee on [Appropriations] with recommendation: To Consent Calendar",6,0,1,0,7
1474180,1051996,2021-04-13,Assembly,"Do pass and be re-referred to the Committee on [Judiciary] with recommendation: To Consent Calendar",7,0,0,0,7
1474180,1057658,2021-04-20,Assembly,"Do pass and be re-referred to the Committee on [Appropriations] with recommendation: To Consent Calendar",10,0,1,0,11
1474180,1073361,2021-05-05,Assembly,"Do pass. To Consent Calendar",16,0,0,0,16
1474180,1077596,2021-05-13,Assembly,"AB 1574 J., E.D. & E. Consent Calendar Second Day Regular Session",75,0,3,0,78
1474181,1027171,2021-03-11,Assembly,"Be adopted. To Consent Calendar",8,0,4,0,12
1474181,1031891,2021-03-18,Assembly,"HR 27 Nguyen Consent Calendar Second Day Regular Session",69,0,9,0,78
1474182,1037837,2021-03-25,Senate,"Senate 3rd Reading SR16 Borgeas",38,0,2,0,40
1475792,1054700,2021-04-15,Assembly,"Do pass and be re-referred to the Committee on [Appropriations] with recommendation: To Consent Calendar",8,0,0,0,8
1475793,1052009,2021-04-13,Assembly,"Do pass and be re-referred to the Committee on [Appropriations] with recommendation: To Consent Calendar",11,0,0,0,11
1475794,1051891,2021-04-13,Assembly,"Do pass and be re-referred to the Committee on [Appropriations] with recommendation: To Consent Calendar",11,0,0,0,11
1475794,1059208,2021-04-21,Assembly,"Do pass. To Consent Calendar",14,0,2,0,16
1475794,1066739,2021-04-29,Assembly,"AB 1577 JUD. Consent Calendar Second Day Regular Session",77,0,1,0,78
1475795,1057630,2021-04-20,Assembly,"Do pass and be re-referred to the Committee on [Appropriations]",9,1,1,0,11
1475796,1052000,2021-04-13,Assembly,"Do pass. To Consent Calendar",11,0,0,0,11
1475796,1056485,2021-04-19,Assembly,"AB 1579 JUD. Consent Calendar Second Day Regular Session",78,0,1,0,79
1475797,1051919,2021-04-13,Assembly,"Do pass. To Consent Calendar",11,0,0,0,11
1475797,1056486,2021-04-19,Assembly,"AB 1580 JUD. Consent Calendar Second Day Regular Session",78,0,1,0,79
1475798,1077577,2021-05-13,Assembly,"Be adopted. To third reading",10,0,2,0,12
1475799,1074141,2021-05-06,Assembly,"Be adopted. To Consent Calendar",11,0,1,0,12
1475799,1077533,2021-05-13,Assembly,"ACR 42 Patterson Consent Calendar Second Day Regular Session",75,0,3,0,78
1475800,1062783,2021-04-26,Senate,"Senate 3rd Reading SCR18 Cortese",32,0,8,0,40
1475801,1033630,2021-03-22,Senate,"Senate 3rd Reading SCR19 Leyva et al",35,0,5,0,40
1475801,1054615,2021-04-15,Assembly,"Be adopted. To Consent Calendar",12,0,0,0,12
1475801,1060925,2021-04-22,Assembly,"SCR 19 Leyva Consent Calendar Second Day Regular Session",77,0,2,0,79
1475802,1044986,2021-04-05,Senate,"Senate 3rd Reading SCR20 Ochoa Bogh et al",38,0,2,0,40
1475802,1054733,2021-04-15,Assembly,"Be adopted. To Consent Calendar",12,0,0,0,12
1475802,1060861,2021-04-22,Assembly,"SCR 20 Ochoa Bogh Consent Calendar Second Day Regular Session",77,0,2,0,79
1475803,1028416,2021-03-15,Senate,"Senate 3rd Reading SCR21 Rubio et al",39,0,1,0,40
1475803,1066718,2021-04-29,Assembly,"Be adopted. To Consent Calendar",9,0,3,0,12
1475803,1074175,2021-05-06,Assembly,"SCR 21 Rubio Consent Calendar Second Day Regular Session",77,0,1,0,78
1475804,1047534,2021-04-06,Senate,"Be adopted. Ordered to third reading",9,0,2,0,11
1475804,1050793,2021-04-12,Senate,"Senate 3rd Reading SJR2 Hueso et al",32,2,6,0,40
1477148,1073409,2021-05-05,Assembly,"Do pass. To Consent Calendar",8,0,0,0,8
1477148,1077523,2021-05-13,Assembly,"AB 1581 L. GOV. Consent Calendar Second Day Regular Session",75,0,3,0,78
1477149,1027165,2021-03-11,Assembly,"Be adopted. To Consent Calendar",8,0,4,0,12
1477149,1031918,2021-03-18,Assembly,"ACR 43 Mullin Consent Calendar Second Day",69,0,9,0,78
1477149,1050804,2021-04-12,Senate,"Assembly 3rd Reading ACR43 Mullin et al",39,0,1,0,40
1477150,1055492,2021-04-15,Senate,"Do pass, but first be re-referred to the Committee on [Appropriations] with the recommendation: To Consent Calendar",7,0,0,0,7
1477150,1075383,2021-05-10,Senate,"Consent Calendar SB821 N.R. & W",37,0,3,0,40
1477151,1055495,2021-04-15,Senate,"Do pass, but first be re-referred to the Committee on [Appropriations] with the recommendation: To Consent Calendar",7,0,0,0,7
1477151,1075237,2021-05-10,Senate,"Consent Calendar SB822 N.R. & W",37,0,3,0,40
1478613,1051988,2021-04-12,Assembly,"Do pass and be re-referred to the Committee on [Appropriations] with recommendation: To Consent Calendar",9,0,2,0,11
1478613,1059276,2021-04-21,Assembly,"Do pass. To Consent Calendar",14,0,2,0,16
1478613,1066727,2021-04-29,Assembly,"AB 1582 REV. & TAX. Consent Calendar Second Day Regular Session",77,0,1,0,78
1478614,1051967,2021-04-12,Assembly,"Do pass and be re-referred to the Committee on [Appropriations] with recommendation: To Consent Calendar",9,0,2,0,11
1478614,1059242,2021-04-21,Assembly,"Do pass. To Consent Calendar",14,0,2,0,16
1478614,1066687,2021-04-29,Assembly,"AB 1583 REV. & TAX. Consent Calendar Second Day Regular Session",77,0,1,0,78
1478615,1067635,2021-04-29,Assembly,"Do pass and be re-referred to the Committee on [Appropriations] with recommendation: To Consent Calendar",8,0,0,0,8
1478615,1076963,2021-05-12,Assembly,"Do pass. To Consent Calendar",16,0,0,0,16
1478617,1053523,2021-04-14,Senate,"Do pass, but first be re-referred to the Committee on [Appropriations] with the recommendation: To Consent Calendar",11,0,0,0,11
1478617,1075359,2021-05-10,Senate,"Consent Calendar SB823 HEALTH",37,0,3,0,40
1478618,1048910,2021-04-08,Senate,"Senate 3rd Reading SCR22 Umberg",38,0,2,0,40
1478619,1037834,2021-03-25,Senate,"Senate 3rd Reading SR17 Gonzalez et al",38,0,2,0,40
1478620,1033628,2021-03-22,Senate,"Senate 3rd Reading SR18 Jones",35,0,5,0,40
1478621,1028410,2021-03-15,Senate,"Senate 3rd Reading SR19 Atkins",39,0,1,0,40
1480288,1051927,2021-04-13,Assembly,"Do pass and be re-referred to the Committee on [Appropriations] with recommendation: To Consent Calendar",15,0,0,0,15
1480288,1059172,2021-04-21,Assembly,"Do pass. To Consent Calendar",14,0,2,0,16
1480288,1066744,2021-04-29,Assembly,"AB 1585 HEALTH Consent Calendar Second Day Regular Session",77,0,1,0,78
1480289,1060981,2021-04-22,Senate,"Do pass, but first be re-referred to the Committee on [Appropriations] with the recommendation: To Consent Calendar",5,0,0,0,5
1480289,1075303,2021-05-10,Senate,"Consent Calendar SB824 GOV. & F",37,0,3,0,40
1480290,1060896,2021-04-22,Senate,"Do pass, but first be re-referred to the Committee on [Appropriations] with the recommendation: To Consent Calendar",5,0,0,0,5
1480290,1075299,2021-05-10,Senate,"Consent Calendar SB825 GOV. & F",37,0,3,0,40
1480291,1077587,2021-05-13,Senate,"Senate 3rd Reading SCR23 Archuleta",38,0,2,0,40
1482842,1054692,2021-04-15,Assembly,"Be adopted and re-referred to the Committee on [Appropriations]",7,0,0,0,7
1482842,1065077,2021-04-28,Assembly,"Be adopted. To Consent Calendar",16,0,0,0,16
1482842,1068213,2021-05-03,Assembly,"ACR 45 Cooper Consent Calendar Second Day Regular Session",76,0,2,0,78
1482844,1051914,2021-04-12,Assembly,"Be adopted. To Consent Calendar",15,0,0,0,15
1482844,1054651,2021-04-15,Assembly,"ACR 47 Stone Consent Calendar Second Day Regular Session",75,0,3,0,78
1482845,1031878,2021-03-18,Assembly,"Be adopted. To third reading",7,0,5,0,12
1482846,1031885,2021-03-18,Assembly,"Be adopted. To third reading",7,0,5,0,12
1482847,1068205,2021-05-03,Senate,"Senate 3rd Reading SR20 Archuleta",36,0,4,0,40
1482848,1062758,2021-04-26,Senate,"Senate 3rd Reading SR21 Pan",38,0,2,0,40
1483607,1031902,2021-03-18,Assembly,"Be adopted. To Consent Calendar",7,0,5,0,12
1483607,1037862,2021-03-25,Assembly,"ACR 48 Rodriguez Consent Calendar Second Day Regular Session",74,0,4,0,78
1483607,1066684,2021-04-29,Senate,"Special Consent ACR48",36,0,4,0,40
1483608,1031881,2021-03-18,Assembly,"Be adopted. To Consent Calendar",7,0,5,0,12
1483608,1037819,2021-03-25,Assembly,"HR 30 Gabriel Consent Calendar Second Day Regular Session",74,0,4,0,78
1483609,1051910,2021-04-13,Senate,"Be adopted, but first be re-referred to the Committee on [Appropriations] with recommendation: To Consent Calendar",15,0,2,0,17
1483609,1075350,2021-05-10,Senate,"Consent Calendar SCR24",37,0,3,0,40
1484364,1060838,2021-04-22,Assembly,"Do pass and be re-referred to the Committee on [Appropriations] with recommendation: To Consent Calendar",21,0,1,0,22
1484365,1060852,2021-04-22,Assembly,"Do pass and be re-referred to the Committee on [Appropriations] with recommendation: To Consent Calendar",21,0,1,0,22
1484366,1060941,2021-04-22,Assembly,"Do pass and be re-referred to the Committee on [Appropriations] with recommendation: To Consent Calendar",21,0,1,0,22
1484367,1060970,2021-04-22,Assembly,"Do pass and be re-referred to the Committee on [Appropriations] with recommendation: To Consent Calendar",21,0,1,0,22
1484368,1031890,2021-03-18,Assembly,"Be adopted. To Consent Calendar",7,0,5,0,12
1484368,1037860,2021-03-25,Assembly,"ACR 49 Choi Consent Calendar Second Day Regular Session",74,0,4,0,78
1484368,1066780,2021-04-29,Senate,"Special Consent ACR49",36,0,4,0,40
1484369,1049012,2021-04-08,Senate,"Senate 3rd Reading SR22 Min",38,0,2,0,40
1484370,1068154,2021-05-03,Senate,"Senate 3rd Reading SR23 Durazo",37,0,3,0,40
1485405,1066729,2021-04-29,Assembly,"Do pass",6,0,1,0,7
1485406,1066747,2021-04-29,Assembly,"Do pass. To Consent Calendar",7,0,0,0,7
1485406,1074104,2021-05-06,Assembly,"AB 1591 E. & R. Consent Calendar Second Day Regular Session",77,0,1,0,78
1485407,1049033,2021-04-08,Assembly,"Be adopted. To third reading",11,0,1,0,12
1485407,1066691,2021-04-29,Senate,"Special Consent ACR50",36,0,4,0,40
1485408,1056404,2021-04-19,Assembly,"Be adopted. To Consent Calendar",15,0,0,0,15
1485408,1060912,2021-04-22,Assembly,"ACR 51 Gabriel Consent Calendar Second Day Regular Session",77,0,2,0,79
1485409,1060881,2021-04-22,Senate,"Senate 3rd Reading SCR25 Hurtado",38,0,2,0,40
1486812,1064025,2021-04-26,Assembly,"Be adopted. To Consent Calendar",15,0,0,0,15
1486812,1066821,2021-04-29,Assembly,"ACR 52 Patterson Consent Calendar Second Day Regular Session",77,0,1,0,78
1486813,1048916,2021-04-07,Assembly,"Be adopted, and re-refer to the Committee on [Appropriations] with recommendation: To Consent Calendar",7,0,0,0,7
1486813,1059225,2021-04-21,Assembly,"Be adopted. To Consent Calendar",14,0,2,0,16
1486813,1062738,2021-04-26,Assembly,"ACR 53 Ward Consent Calendar Second Day",77,0,1,0,78
1486814,1064070,2021-04-27,Senate,"Be adopted, but first be re-referred to the Committee on [Appropriations] with recommendation: To Consent Calendar",15,0,2,0,17
1486814,1077585,2021-05-13,Senate,"Consent Calendar SCR26 Gonzalez et al",37,0,3,0,40
1487409,1054679,2021-04-15,Assembly,"Be adopted. To third reading",12,0,0,0,12
1487409,1068289,2021-05-03,Senate,"Assembly 3rd Reading ACR54",36,0,4,0,40
1487410,1074176,2021-05-06,Assembly,"Be adopted. To third reading",11,0,1,0,12
1487411,1037827,2021-03-25,Assembly,"Be adopted. To third reading",9,0,3,0,12
1487411,1066750,2021-04-29,Senate,"Special Consent ACR56",36,0,4,0,40
1487412,1056390,2021-04-19,Senate,"Do pass, but first be re-referred to the Committee on [Governance and Finance] with the recommendation: To Consent Calendar",13,0,1,0,14
1487413,1064128,2021-04-27,Senate,"Be adopted, but first be re-referred to the Committee on [Appropriations] with recommendation: To Consent Calendar",15,0,2,0,17
1487413,1077602,2021-05-13,Senate,"Consent Calendar SCR27 McGuire et al",37,0,3,0,40
1487414,1064017,2021-04-27,Senate,"Be adopted, but first be re-referred to the Committee on [Appropriations] with recommendation: To Consent Calendar",15,0,2,0,17
1487414,1077539,2021-05-13,Senate,"Consent Calendar SCR28",38,0,2,0,40
1487975,1037821,2021-03-25,Assembly,"Be adopted. To Consent Calendar",9,0,3,0,12
1487975,1048980,2021-04-08,Assembly,"HR 31 Low Consent Calendar Second Day Regular Session",74,0,4,0,78
1487976,1048990,2021-04-08,Senate,"Senate 3rd Reading SCR29 Wiener et al",38,0,2,0,40
1488591,1065259,2021-04-28,Assembly,"Do pass. To Consent Calendar",8,0,0,0,8
1488591,1074106,2021-05-06,Assembly,"AB 1592 L. GOV. Consent Calendar Second Day Regular Session",77,0,1,0,78
1488593,1054639,2021-04-15,Assembly,"Be adopted. To Consent Calendar",12,0,0,0,12
1488593,1060833,2021-04-22,Assembly,"ACR 60 Fong Consent Calendar Second Day Regular Session",77,0,2,0,79
1488594,1054604,2021-04-15,Assembly,"Be adopted. To third reading",12,0,0,0,12
1488594,1068151,2021-05-03,Senate,"Assembly 3rd Reading ACR61",36,0,4,0,40
1488595,1048888,2021-04-08,Assembly,"Be adopted. To third reading",11,0,1,0,12
1488596,1064112,2021-04-27,Senate,"Do pass, but first be re-referred to the Committee on [Appropriations] with the recommendation: To Consent Calendar",5,0,0,0,5
1488596,1077560,2021-05-13,Senate,"Consent Calendar SB827 PUB. S",38,0,2,0,40
1488597,1066743,2021-04-29,Senate,"Senate 3rd Reading SCR30 Dahle",36,0,4,0,40
1488598,1065109,2021-04-28,Senate,"Be adopted and be ordered to the Consent Calendar",7,0,0,0,7
1488598,1075317,2021-05-10,Senate,"Consent Calendar SJR3 Archuleta",37,0,3,0,40
1491579,1076929,2021-05-12,Assembly,"Do pass",16,0,0,0,16
1491580,1048951,2021-04-08,Assembly,"Be adopted as amended",11,0,1,0,12
1491580,1068253,2021-05-03,Senate,"Assembly 3rd Reading ACR62",36,0,4,0,40
1491581,1048932,2021-04-08,Assembly,"Be adopted. To third reading",11,0,1,0,12
1491581,1066720,2021-04-29,Senate,"Special Consent ACR63",36,0,4,0,40
1491582,1056389,2021-04-19,Assembly,"Be adopted. To Consent Calendar",15,0,0,0,15
1491582,1062779,2021-04-26,Assembly,"ACR 64 Fong Assembly Third Reading",75,0,3,0,78
1491583,1054658,2021-04-15,Assembly,"Be adopted. To third reading",12,0,0,0,12
1491584,1054695,2021-04-15,Assembly,"Be adopted. To Consent Calendar",12,0,0,0,12
1491584,1060811,2021-04-22,Assembly,"ACR 66 Cooley Consent Calendar Second Day Regular Session",77,0,2,0,79
1491586,1066702,2021-04-29,Senate,"Senate 3rd Reading SCR31 Newman",37,0,3,0,40
1491587,1066832,2021-04-29,Senate,"Senate 3rd Reading SCR32 Gonzalez",37,0,3,0,40
1491588,1066793,2021-04-29,Senate,"Senate 3rd Reading SR24 Umberg",36,0,4,0,40
1491589,1054596,2021-04-15,Senate,"Senate 3rd Reading SR25 Wieckowski",38,0,2,0,40
1492083,1066746,2021-04-29,Assembly,"Be adopted. To third reading",9,0,3,0,12
1492084,1048981,2021-04-08,Assembly,"Be adopted. To third reading",11,0,1,0,12
1492085,1057715,2021-04-20,Senate,"Do pass, but first be re-referred to the Committee on [Appropriations] with the recommendation: To Consent Calendar",15,0,0,0,15
1492085,1068157,2021-05-03,Senate,"Placed on suspense file",6,0,1,0,7
1492420,1064061,2021-04-26,Assembly,"Be adopted. To Consent Calendar",15,0,0,0,15
1492420,1066719,2021-04-29,Assembly,"ACR 67 Quirk-Silva Consent Calendar Second Day Regular Session",77,0,1,0,78
1492421,1074103,2021-05-06,Assembly,"Be adopted. To Consent Calendar",11,0,1,0,12
1492421,1077550,2021-05-13,Assembly,"ACR 68 O'Donnell Consent Calendar Second Day Regular Session",75,0,3,0,78
1492422,1056415,2021-04-19,Senate,"Senate 3rd Reading SR26 Gonzalez",37,0,3,0,40
1492855,1075385,2021-05-10,Senate,"Senate 3rd Reading SCR33 Archuleta et al",36,0,4,0,40
1493521,1074133,2021-05-06,Assembly,"Be adopted. To Consent Calendar",11,0,1,0,12
1493521,1077569,2021-05-13,Assembly,"ACR 69 Nguyen Consent Calendar Second Day Regular Session",75,0,3,0,78
1493522,1060997,2021-04-22,Assembly,"Be adopted. To third reading",12,0,0,0,12
1493524,1068188,2021-05-03,Senate,"Senate 3rd Reading SR27 Limón",36,0,4,0,40
1500881,1072227,2021-05-04,Assembly,"Be adopted. To Consent Calendar",11,0,0,0,11
1500881,1074168,2021-05-06,Assembly,"AJR 12 Stone Consent Calendar Second Day Regular Session",77,0,1,0,78
1500883,1062800,2021-04-26,Senate,"Senate 3rd Reading SR28 Rubio et al",38,0,2,0,40
1500884,1062749,2021-04-26,Senate,"Senate 3rd Reading SR29 Archuleta et al",38,0,2,0,40
1501652,1066711,2021-04-29,Assembly,"Be adopted. To Consent Calendar",9,0,3,0,12
1501652,1074154,2021-05-06,Assembly,"ACR 71 Villapudua Consent Calendar Second Day Regular Session",77,0,1,0,78
1501653,1074136,2021-05-06,Senate,"Senate 3rd Reading SCR38 Pan",37,0,3,0,40
1501655,1068178,2021-05-03,Senate,"Senate 3rd Reading SR30 Hueso",36,0,4,0,40
1502692,1060820,2021-04-22,Assembly,"Be adopted. To third reading",12,0,0,0,12
1503852,1074185,2021-05-06,Assembly,"Be adopted. To third reading",11,0,1,0,12
1503853,1077589,2021-05-13,Assembly,"Be adopted. To third reading",10,0,2,0,12
1503854,1074123,2021-05-06,Assembly,"Be adopted. To Consent Calendar",11,0,1,0,12
1503854,1077599,2021-05-13,Assembly,"ACR 77 Bennett Consent Calendar Second Day Regular Session",75,0,3,0,78
1503855,1066791,2021-04-29,Assembly,"Be adopted. To third reading",9,0,3,0,12
1503856,1075365,2021-05-10,Senate,"Senate 3rd Reading SCR40 Allen",37,0,3,0,40
1504273,1066755,2021-04-29,Assembly,"Be adopted. To third reading",9,0,3,0,12
1504274,1077623,2021-05-13,Assembly,"Be adopted. To third reading",10,0,2,0,12
1505163,1077595,2021-05-13,Assembly,"Be adopted. To third reading",10,0,2,0,12
1505859,1074197,2021-05-06,Assembly,"Be adopted. To third reading",11,0,1,0,12
1506759,1077527,2021-05-13,Senate,"Senate 3rd Reading SR34 Grove et al",38,0,2,0,40
1506760,1077588,2021-05-13,Senate,"Senate 3rd Reading SR35 Grove",38,0,2,0,40
1507739,1077590,2021-05-13,Assembly,"Be adopted. To third reading",10,0,2,0,12
1507741,1077574,2021-05-13,Senate,"Senate 3rd Reading SCR44 Atkins et al",38,0,2,0,40
